他们一边学习毛主席语录，一边等候着时传祥等工人同志。	{'year': '1966', 'genre': 'press reportage', 'name': "People' Daily"}
我们一定要把资本主义、修正主义的根子从一切阴暗的角落里挖出来，砸它个稀巴烂！”	{'year': '1966', 'genre': 'press reportage', 'name': "People' Daily"}
“对不起，我长这么大，还从没有接受过别人的恩惠，更不消说是接受你这种人的恩惠了。”	{'year': '1966', 'genre': 'press reportage', 'name': "People' Daily"}
顾客们可以在这儿买到不同的裁好了的便服裤腰、鞋面、布沿、领子、补钉布等等。	{'year': '1966', 'genre': 'press reportage', 'name': "People' Daily"}
这两天，医务人员为他们做了全面的身体检查和透视检查，还指定神经科以及内、外科医生，为被拷打而致脑震荡的青少年会诊和治疗。	{'year': '1966', 'genre': 'press reportage', 'name': "People' Daily"}
可惜这件礼物被敌人搜去了。”	{'year': '1966', 'genre': 'press reportage', 'name': "People' Daily"}
你们斗争得很坚决，很勇敢，斗垮了印尼反动派，这是毛泽东思想的胜利！”	{'year': '1966', 'genre': 'press reportage', 'name': "People' Daily"}
讲两句和气话有什么要紧，讲了就释放你，你出去还不是该干什么干什么。”	{'year': '1966', 'genre': 'press reportage', 'name': "People' Daily"}
阮氏珠同志的光辉事迹，再一次有力地向全世界宣告：	{'year': '1966', 'genre': 'press reportage', 'name': "People' Daily"}
澳葡当局这一法西斯血腥暴行，激起了澳门同胞极大的愤慨。	{'year': '1966', 'genre': 'press reportage', 'name': "People' Daily"}
特别是要求澳葡当局严办这次血腥暴行的祸首“警察厅第一副厅长”颜端尼，并公开向澳门同胞道歉赔罪。	{'year': '1966', 'genre': 'press reportage', 'name': "People' Daily"}
我们山西太谷卫生学校“革命长征队”的五十九名战士，怀着对毛主席无比热爱的心情，遵照毛主席关于在大风大浪里经受锻炼的教导，徒步来到了无产阶级文化大革命的中心——北京。	{'year': '1966', 'genre': 'press reportage', 'name': "People' Daily"}
敌人硬的软的都可耻地失败了，珠姐同敌人进行了一千三百多天的英勇斗争，走出了监狱，回到了自己的家。	{'year': '1966', 'genre': 'press reportage', 'name': "People' Daily"}
珠姐常常对娟姐讲起阮文追，使娟姐懂得了，作为阮文追的妻子，应当承担起一种神圣的责任，那就是和这位坚强的革命战士共同经受一切考验。	{'year': '1966', 'genre': 'press reportage', 'name': "People' Daily"}
由于夜深，精神过度紧张，本来记得在体育馆附近的住宿地又忘记了。	{'year': '1966', 'genre': 'press reportage', 'name': "People' Daily"}
“不必这么仇恨我们，我们不过是为了拯救国家，要把侵犯国家独立的人赶出去。	{'year': '1966', 'genre': 'press reportage', 'name': "People' Daily"}
‘你做得对，追哥，我要永远和你在一起，就是坐牢坐到死，也决不向敌人屈服！	{'year': '1966', 'genre': 'press reportage', 'name': "People' Daily"}
他们回到湛江后，经过医务人员认真诊治和细心护理，现在都逐渐恢复健康。	{'year': '1966', 'genre': 'press reportage', 'name': "People' Daily"}
据越南南方解放通讯社报道，广义省山河、思义和山晶三个县的游击队和地方部队，从三日到六日，英勇反击敌人的“扫荡”和袭击敌人据点，共打死打伤和俘虏美伪军及南朝鲜帮凶军三百多名，其中歼灭美国侵略军一个连、伪军五个排和一个“绥靖”队，烧毁汽油库和弹药库各一座，击毁军用船只九艘、军车五辆，缴获大批武器弹药。	{'year': '1967', 'genre': 'press reportage', 'name': "People' Daily"}
影片大肆宣扬单干的“优越性”，想以此告诉人们，只要象高正国那样坚决搞单干，那么个人发家致富的“五年计划”很快就可以实现，什么买牛置车呀，什么买田置地呀，什么金钱钞票呀，会应有尽有，小日子就会越过越兴旺。	{'year': '1967', 'genre': 'press reportage', 'name': "People' Daily"}
在开罗的非洲进步青年和学生高度赞扬中国红卫兵在战无不胜的毛泽东思想指导下敢于闹革命的大无畏精神，并决心以红卫兵为榜样，努力学习毛主席著作，为非洲人民反对帝国主义、争取民族解放的斗争作出贡献。	{'year': '1967', 'genre': 'press reportage', 'name': "People' Daily"}
建祥省解放武装力量八月二日在一次阻击战中，歼灭敌军一个连，缴获武器数十件以及许多弹药和军用物资。	{'year': '1967', 'genre': 'press reportage', 'name': "People' Daily"}
“这个展览会对我们莫三鼻给青年来说是一个大课堂。	{'year': '1967', 'genre': 'press reportage', 'name': "People' Daily"}
他创造的思想和理论是当代马克思列宁主义的顶峰。	{'year': '1967', 'genre': 'press reportage', 'name': "People' Daily"}
“我们今后要在毛泽东思想的指导下，走真正的革命道路，在群众斗争的烈火中锻炼自己，冲洗过去的错误思想，不仅以客观世界为革命的对象，还要以自己为革命的对象，努力改造自己，使自己能够完全、彻底为人民服务。”	{'year': '1967', 'genre': 'press reportage', 'name': "People' Daily"}
反动警察当局对群众的抗议示威怕得要死，竟出动八百多名警察对工人进行镇压。	{'year': '1967', 'genre': 'press reportage', 'name': "People' Daily"}
在《两家人》里，看不到高高飘扬着的毛泽东思想伟大红旗，看不到轰轰烈烈的农业合作化的群众运动，看不到广大贫下中农无限热爱毛主席、坚决走社会主义道路的赤胆忠心，更看不到解放后农村欣欣向荣的繁荣景象。	{'year': '1967', 'genre': 'press reportage', 'name': "People' Daily"}
他们懂得了无产阶级革命的中心问题是政权问题，是打碎旧的国家机器，建立新的国家机器。	{'year': '1967', 'genre': 'press reportage', 'name': "People' Daily"}
“也想买点好吃的，可实际情况你们也知道，老百姓都撤退了，想给你们买也买不到哇！”	{'year': '1967', 'genre': 'press reportage', 'name': "People' Daily"}
在越南是这样，在阿拉伯地区是这样，在世界上许多地区都是这样。	{'year': '1967', 'genre': 'press reportage', 'name': "People' Daily"}
大家深深体会到，这是实行合作医疗、贯彻落实“预防为主”方针的结果。	{'year': '1968', 'genre': 'press reportage', 'name': "People' Daily"}
南方军民发扬革命英雄主义，把军事、政治和兵运斗争紧密地结合起来，已经战胜了一百二十万敌军，其中包括五十多万美军；在城市和农村都取得了胜利，在敌军的基地、机场、港口、仓库、交通运输都打得好；又解放了许多居民稠密的辽阔地区，边战斗边建设，军事和政治力量都飞跃地壮大；战斗好，实现民族解放阵线的政策也好，部队全心全意地保卫和帮助人民，人民全心全意地爱护和帮助部队，同部队一起英勇杀敌。	{'year': '1968', 'genre': 'press reportage', 'name': "People' Daily"}
“是毛主席他老人家给了我第二次生命，要不是办合作医疗，我那里花得起这么多钱看病？	{'year': '1968', 'genre': 'press reportage', 'name': "People' Daily"}
接着，解放军在二十七日上午又用重型武器击伤从西贡开往头顿的一艘载重五千吨的美国军用运输船，使这条船起火猛烈燃烧。	{'year': '1968', 'genre': 'press reportage', 'name': "People' Daily"}
以前，医生为了看病学技术、增收入，对预防工作一向不关心；实行合作医疗以后，他们深深感到做好预防工作的重要性，积极带头，发动群众，开展“人民战争”，踏踏实实做好预防工作，增进社员健康。	{'year': '1968', 'genre': 'press reportage', 'name': "People' Daily"}
那些叛徒、特务、资产阶级反动“权威”，被他们当成宝贝，一个个安插到各级领导岗位上。	{'year': '1968', 'genre': 'press reportage', 'name': "People' Daily"}
我们欢迎，这是想都想不来的好事。	{'year': '1968', 'genre': 'press reportage', 'name': "People' Daily"}
农村的钱，有时有，有时没有。	{'year': '1968', 'genre': 'press reportage', 'name': "People' Daily"}
上钢三厂革委会副主任、工人李步华：	{'year': '1968', 'genre': 'press reportage', 'name': "People' Daily"}
公社卫生所的医务人员怎样安排？	{'year': '1968', 'genre': 'press reportage', 'name': "People' Daily"}
结算以后，用钱的地方多得很，谁家留些钱等着治病用？”	{'year': '1968', 'genre': 'press reportage', 'name': "People' Daily"}
为了达到这个目的，约翰逊一方面大肆赞扬泰国为侵越战争作出了“贡献”，并表示愿意继续对泰国反动派提供“援助”，同时又强调南越傀儡集团的命运“对这个地区的其他国家安全的重要性”，叫嚷美国“无意放弃在东南亚承担的军事和经济义务”而“断送亚洲”。	{'year': '1968', 'genre': 'press reportage', 'name': "People' Daily"}
我们集中了工人群众的集体智慧，提出了完全打破外国框框和适合我国资源、设备条件的热轧工艺，坚定不移地走自己工业发展的道路。	{'year': '1968', 'genre': 'press reportage', 'name': "People' Daily"}
革委会成员认为这是符合毛主席革命路线的新生事物，立即给予支持。	{'year': '1969', 'genre': 'press reportage', 'name': "People' Daily"}
毛主席“清理阶级队伍，一是要抓紧，二是要注意政策”的最新指示发表后，彬县革委会进行了认真的学习，大家认识到，要迅速落实毛主席的最新指示，领导成员必须亲临对敌斗争的第一线，和广大革命群众并肩战斗，带领广大群众向一小撮阶级敌人展开进攻，才能打好清理阶级队伍这一仗。	{'year': '1969', 'genre': 'press reportage', 'name': "People' Daily"}
正如伟大列宁指出的：	{'year': '1969', 'genre': 'press reportage', 'name': "People' Daily"}
青海这个单位的某些同志所以写信询问，显然认为下放劳动的人准有问题，但是，他们大概从来也没有想到过自己头脑里的“劳动惩罚论”会有什么问题。	{'year': '1969', 'genre': 'press reportage', 'name': "People' Daily"}
直到这次文化大革命，从革命群众的揭发中，才知道供应我洗澡的水，也是车站工人从一、二里路远的地方挑来的。	{'year': '1969', 'genre': 'press reportage', 'name': "People' Daily"}
文化大革命前，我认为自己是工农干部，根子红，苗子壮，又在农村工作，经常和群众打交道，不参加劳动，也忘不了本，变不了质，脱离不了群众。	{'year': '1969', 'genre': 'press reportage', 'name': "People' Daily"}
革命大批判的巨浪，涤荡着学员们灵魂深处的“刘毒”，大家这才认识到，所有这些不服气，统统是“官气”。	{'year': '1969', 'genre': 'press reportage', 'name': "People' Daily"}
正是大工贼刘少奇，在新中国成立后，大搞阶级投降主义，从根本上背叛了毛主席对私营工商业实行社会主义改造的无产阶级革命路线！	{'year': '1969', 'genre': 'press reportage', 'name': "People' Daily"}
这两个干部是响应毛主席的伟大号召，走《五·七指示》指引的光辉道路的；并询问来信的同志究竟学习过还是没有学习过毛主席光辉的《五·七指示》和毛主席关于“广大干部下放劳动”的指示？	{'year': '1969', 'genre': 'press reportage', 'name': "People' Daily"}
一次，我到一个公社蹲点，见社员出门都背着粪筐，自己背不背呢？	{'year': '1969', 'genre': 'press reportage', 'name': "People' Daily"}
抓住了这样的典型，用这样的典型经验指导一般，就能取得领导运动的主动权。	{'year': '1969', 'genre': 'press reportage', 'name': "People' Daily"}
“参加革命前的二十二年，是过剥削阶级生活的二十二年，参加革命后的二十二年，又走了当官做老爷的道路，今后还能工作几十年，要成为继续革命、为人民立新功的几十年。”	{'year': '1969', 'genre': 'press reportage', 'name': "People' Daily"}
想战争年代如何不怕苦，不怕死，不为名，不为利，一心干革命；比进城以后当了“官”，如何贪享受，图安逸，逐步变修；看现在重新学习，如何参加劳动，联系群众，继续革命。	{'year': '1969', 'genre': 'press reportage', 'name': "People' Daily"}
他马上把身上的雨衣和外衣脱下，盖在货物上。	{'year': '1970', 'genre': 'press reportage', 'name': "People' Daily"}
有的售货员顺手拿一张包装纸包东西，他就耐心地解释说：	{'year': '1970', 'genre': 'press reportage', 'name': "People' Daily"}
中曾根的这番话供认了日本军国主义梦寐以求的侵略目标，那就是企图挤进所谓“超级大国”的行列，特别是同美帝国主义勾结起来，由日本军国主义主宰亚洲和太平洋地区。	{'year': '1970', 'genre': 'press reportage', 'name': "People' Daily"}
中曾根在讲话中叫嚷说，“自由世界的中心是美、日和统一的欧洲”，日本“已经重振了经济力量”，“亚洲、太平洋的安宁是以美日合作为基础的”。	{'year': '1970', 'genre': 'press reportage', 'name': "People' Daily"}
他发现地上掉了一个大头针，就拾起来交给营业员再用，看见炉灰里没有烧透的煤核，便拣出来再烧。	{'year': '1970', 'genre': 'press reportage', 'name': "People' Daily"}
日本侵略势力已经打入亚洲广大地区，除了我国台湾省和南朝鲜，还打入了菲律宾、泰国、“马来西亚”、新加坡、印尼、南越、老挝、印度等国家和地区。	{'year': '1970', 'genre': 'press reportage', 'name': "People' Daily"}
在日本统治集团看来，日本的经济力量已经大大膨胀，而日本的军事力量同经济力量还不相“适应”。	{'year': '1970', 'genre': 'press reportage', 'name': "People' Daily"}
而这次会议刚一结束，他就立即从惠灵顿直接飞往美国，向美国国务卿罗杰斯汇报。	{'year': '1970', 'genre': 'press reportage', 'name': "People' Daily"}
大隗大队依靠贫下中农管理财会工作后，通过从财会工作中反映出来的两个阶级、两条道路、两条路线的斗争，组织贫下中农狠批“物质刺激”，坚持无产阶级政治挂帅；狠批“自由经营”，坚持社会主义计划生产；狠批“分光吃光”，坚持正确处理国家、集体、个人三者之间关系；狠批摆阔气、讲排场的大少爷作风，坚持艰苦奋斗、勤俭办社的方针，克服了队里存在的一些生产没计划、成本不核算、收入不问来源、支出不看方向的现象，发展了农业生产，巩固了集体经济。	{'year': '1970', 'genre': 'press reportage', 'name': "People' Daily"}
中曾根的这番话，是在向坚决反对美日反动派复活日本军国主义的中朝两国人民进行疯狂反扑，是日本军国主义蓄意与日本人民、朝鲜人民、中国人民、东南亚和亚洲各国人民为敌到底的自供状。	{'year': '1970', 'genre': 'press reportage', 'name': "People' Daily"}
他们一再渲染日本已成为“自由世界”仅次于美国的所谓“大国”，一再叫嚷要发挥所谓大国的作用。	{'year': '1970', 'genre': 'press reportage', 'name': "People' Daily"}
他的这番话，反映了日本反动统治集团对日本人民和亚洲人民日益高涨的反对美日反动派复活日本军国主义斗争的恐惧和不安；也反映了日本军国主义势力死心塌地跟随美帝疯狂向海外侵略扩张的急迫心情和更加凶恶的野心。	{'year': '1970', 'genre': 'press reportage', 'name': "People' Daily"}
广大革命群众称赞他是社会主义商业阵地的红哨兵，活学活用毛泽东思想的好榜样。	{'year': '1970', 'genre': 'press reportage', 'name': "People' Daily"}
十来名美军聚成一团，企图逃命。	{'year': '1971', 'genre': 'press reportage', 'name': "People' Daily"}
公报说，经过四十五个昼夜的顽强战斗，溪山战场解放军已使三千多名敌人丧失战斗力，其中包括美军二千名，全歼西贡伪军第三十九别动营，重创美国步兵、机械化部队和炮兵的许多单位，俘虏敌人一百多名，击落和击毁敌机近一百架，活捉一批飞贼，击毁军车三百五十辆，其中坦克和装甲车一百多辆，击沉运输船只二十三艘，烧毁后勤仓库二十座，其中包括贮藏成百万公升汽油、几万发炮弹和成千吨军用物资的仓库，缴获许多武器和弹药。	{'year': '1971', 'genre': 'press reportage', 'name': "People' Daily"}
这时候，四架美国飞机投下了燃烧弹，妄图切断解放军的前进道路。	{'year': '1971', 'genre': 'press reportage', 'name': "People' Daily"}
此后，我们连走一天查一次战备思想，走一路搞一路路线教育，从难从严，自找苦吃，自觉磨练。	{'year': '1971', 'genre': 'press reportage', 'name': "People' Daily"}
指导员一马当先，高呼：	{'year': '1971', 'genre': 'press reportage', 'name': "People' Daily"}
我一到连队就听到战士们议论：	{'year': '1971', 'genre': 'press reportage', 'name': "People' Daily"}
十年来，三连指战员就是这样用普通的武器同拥有现代化装备的美国侵略军、伪军和仆从军进行了近百次战斗，打死敌人二千三百名（其中美军六百二十名），俘虏敌人近二百名，击落敌机六架，缴获各种武器近四百件，荣获越南南方解放武装力量指挥部授予的“决胜铜墙单位”的光荣称号。	{'year': '1971', 'genre': 'press reportage', 'name': "People' Daily"}
“群众中蕴藏了这样大的社会主义的积极性，为什么在许多领导机关，在几个月以前，居然没有感觉到，或者感觉的那样少呢？	{'year': '1971', 'genre': 'press reportage', 'name': "People' Daily"}
连长和指导员马上抓住时机，跳出工事，率领战友们冲锋。	{'year': '1971', 'genre': 'press reportage', 'name': "People' Daily"}
本来驭手班的工作就很忙，最近又增加了几匹新牲口，战士们每天起得早，睡得晚；宿舍紧靠着马棚，晚上蚊子多，牲口撩蹄子，折腾得睡不好觉，我在驭手班连着住了几个晚上，到团里开会白天也打瞌睡了。	{'year': '1971', 'genre': 'press reportage', 'name': "People' Daily"}
公报指出，溪山战场解放军取得的这一胜利，为打败美伪集团侵略老挝南部的大规模军事行动作出了重大贡献，有力地鼓舞了越南人民的斗争，使敌人的士气更加低落。	{'year': '1971', 'genre': 'press reportage', 'name': "People' Daily"}
我给大家讲了这些道理以后，四班从大路上折回赶部队了，但仍有些同志思想转不过弯来，当碰到路难走，需要卸驮子，用人扛武器的时候，就嘀咕起来。	{'year': '1971', 'genre': 'press reportage', 'name': "People' Daily"}
在‘孟加拉国’申请参加联合国的问题上，中国代表团从维护联合国宪章的原则、维护体现全世界绝大多数国家意志的联合国有关决议、维护南亚次大陆全体人民的根本利益，并且从促使南亚次大陆紧张局势缓和的愿望出发，提出在联合国和安理会的有关决议真正得到实施之前，在印、巴之间和巴基斯坦、‘孟加拉国’之间的问题得到合理解决之前，安理会不应该对该申请进行审议；也就是说，在上述决议得到彻底实施之前，安理会必须推迟对该申请的审议，以便为南亚次大陆的问题获得合理解决创造条件。	{'year': '1972', 'genre': 'press reportage', 'name': "People' Daily"}
西丽玛沃·班达拉奈克总理的随行人员，斯里兰卡驻中国大使卡朗纳戈达和夫人也前往参观。	{'year': '1972', 'genre': 'press reportage', 'name': "People' Daily"}
在我离开北京的前夕，我借此机会向你们大家表示欢迎，并感谢你们今晚的光临，以及在我在这一城市的短暂逗留期间向我表示的诚挚和友谊。	{'year': '1972', 'genre': 'press reportage', 'name': "People' Daily"}
不论已否承认“孟加拉国”，联合国的会员国都首先有不可推卸的义务去促使这些决议得到彻底实施，促使印—巴、“孟加拉国”—巴基斯坦平等协商，达成协议，合理地解决它们之间的问题；然后才好考虑“孟加拉国”的申请，因此，安理会无论如何也不能屈从于苏联和印度等国代表团的无理要求。	{'year': '1972', 'genre': 'press reportage', 'name': "People' Daily"}
苏联社会帝国主义在南亚次大陆和世界各地对别的国家进行侵略、干涉、控制和颠覆的事实不胜枚举。”	{'year': '1972', 'genre': 'press reportage', 'name': "People' Daily"}
两张图，要分清，旧的黑来新的红。	{'year': '1972', 'genre': 'press reportage', 'name': "People' Daily"}
我能同周恩来总理重叙旧谊，确实极感愉快，他是斯里兰卡很亲密的朋友，曾多次访问过我国。	{'year': '1972', 'genre': 'press reportage', 'name': "People' Daily"}
他的诗歌，正是在火热的群众斗争中，在新旧社会两层天的切身经历中写出来的。	{'year': '1972', 'genre': 'press reportage', 'name': "People' Daily"}
经过广大干部和社员的努力，把修渠、打井、建塘、筑库结合起来，使全县的灌溉能力比文化大革命以前提高两倍多。	{'year': '1972', 'genre': 'press reportage', 'name': "People' Daily"}
苏联和印度代表在他们强加于安理会和联合国的提案遭到否决后，先后发言，恶毒诬蔑和攻击中国坚决维护联合国宪章的原则、联合国的有关决议以及南亚次大陆和全世界人民的利益这一正确立场。	{'year': '1972', 'genre': 'press reportage', 'name': "People' Daily"}
他们号召本省、区的工人认真学习马克思主义、列宁主义、毛泽东思想，坚持党在社会主义历史阶段的基本路线，继续抓紧抓好批修整风这个头等大事，不断提高阶级斗争和两条路线斗争觉悟，加强工人阶级的革命团结，加强工人阶级和一切革命人民的革命团结，为加快社会主义建设的步伐，进一步巩固无产阶级专政，实现工人阶级的伟大历史使命而奋勇前进。	{'year': '1973', 'genre': 'press reportage', 'name': "People' Daily"}
新西兰方面欢迎在惠灵顿建立中国大使馆，并表示将在不久的将来在北京建立新西兰大使馆。	{'year': '1973', 'genre': 'press reportage', 'name': "People' Daily"}
代表们指出，当前各级工会首先要抓好批修整风这个头等大事，组织工人群众认真学习马列著作和毛主席著作，深入批判刘少奇一类骗子修正主义路线的极右实质。	{'year': '1973', 'genre': 'press reportage', 'name': "People' Daily"}
蒙古驻中国大使索苏尔巴拉姆，匈牙利驻中国大使戈多尔，波兰驻中国大使斯塔霍维亚克，捷克斯洛伐克驻中国大使馆商务参赞什特尔泽尔，德意志民主共和国驻中国大使馆商务参赞卢德维希。	{'year': '1973', 'genre': 'press reportage', 'name': "People' Daily"}
帝国主义统治的宝座，一个又一个地倒塌。	{'year': '1973', 'genre': 'press reportage', 'name': "People' Daily"}
以交通部副部长郭鲁为团长的中国政府代表团五月二十四日下午到达赞比亚首都卢萨卡。	{'year': '1973', 'genre': 'press reportage', 'name': "People' Daily"}
阿尔及利亚政府已经把在阿尔及利亚经营的外国石油公司的百分之五十一的股份收归国有。	{'year': '1973', 'genre': 'press reportage', 'name': "People' Daily"}
在柬埔寨人民抗美救国战争捷报频传的日子里，庆祝柬埔寨民族统一阵线和柬埔寨民族解放人民武装力量成立三周年的图片，在首都中国美术馆隆重展出了。	{'year': '1973', 'genre': 'press reportage', 'name': "People' Daily"}
一九七一年第八届非洲国家和政府首脑会议通过了“关于非洲国家对其自然资源拥有永久主权的决议”、“关于非洲国家对其在非洲沿海的渔业资源拥有永久主权的决议”以及“关于发展非洲工业、促进非洲国家之间的贸易、文化交流”等决议。	{'year': '1973', 'genre': 'press reportage', 'name': "People' Daily"}
我们深信，在印度支那人民和全世界人民的支持下，柬埔寨人民团结战斗，一定能够取得抗美救国斗争事业的最后胜利。	{'year': '1973', 'genre': 'press reportage', 'name': "People' Daily"}
阿富汗首相穆罕默德·穆萨·沙菲克五月二十三日晚在这里接见中国驻阿富汗大使甘野陶，同他进行了亲切友好的谈话。	{'year': '1973', 'genre': 'press reportage', 'name': "People' Daily"}
塞浦路斯是地中海的第三大岛，也是地中海中属于亚洲的一个岛屿。	{'year': '1974', 'genre': 'press reportage', 'name': "People' Daily"}
这样，就带动了广大群众，全厂培养出了一支敢打硬仗的职工队伍。	{'year': '1974', 'genre': 'press reportage', 'name': "People' Daily"}
批林批孔中，北京大学工农兵学员继承和发扬“五四”时期革命青年的大无畏的反潮流精神，向林彪鼓吹的孔孟之道猛烈开火。	{'year': '1974', 'genre': 'press reportage', 'name': "People' Daily"}
广大工农兵群众和革命干部、革命知识分子，认真学习马列著作和毛主席著作，联系现实的阶级斗争和两条路线斗争，深入批判林彪效法孔老二“克己复礼”的反革命罪行及其修正主义路线，深入批判反动没落阶级的意识形态孔孟之道，回击否定无产阶级文化大革命，敌视社会主义新生事物，复辟资本主义的反动思潮。	{'year': '1974', 'genre': 'press reportage', 'name': "People' Daily"}
目前，云南省已经建立起数以百计的县办骨干工厂，包括铁厂（矿）、有色金属矿、煤矿、化肥厂、农机厂、水泥厂、小电厂等，还有数以千计的农村人民公社办的小铁矿点、小有色金属矿点、小煤窑、小水电站和小农机修理厂等。	{'year': '1974', 'genre': 'press reportage', 'name': "People' Daily"}
以乔森潘副首相为团长、英·萨利特别顾问为副团长的柬埔寨民族统一阵线和王国民族团结政府代表团，应阿拉伯叙利亚共和国政府的邀请，五月十五日晚乘专机到达大马士革，对叙利亚进行正式友好访问。	{'year': '1974', 'genre': 'press reportage', 'name': "People' Daily"}
我们厂从文化大革命以来，全厂职工深入批判崇洋迷外、爬行主义等修正主义黑货，批判林彪卖国主义的罪行，坚持自力更生、艰苦奋斗，大搞技术革新和技术改造，实现了三百多项重大革新，自制了一百多台设备，搞成了六条自动生产线，一条流水线，使生产能力提高三分之一以上，现在已能生产几十种先进产品。	{'year': '1974', 'genre': 'press reportage', 'name': "People' Daily"}
“我们完全支持被压迫人民反对殖民主义的斗争。	{'year': '1974', 'genre': 'press reportage', 'name': "People' Daily"}
在批林批孔斗争中，北京大学哲学系的第一届工农兵学员破除迷信，解放思想，敢于对这个反动阶级的“经典”开刀。	{'year': '1974', 'genre': 'press reportage', 'name': "People' Daily"}
广东省琼海县农机修造厂党委副书记彭业煌和工人们一起学习四届人大文件，决心实现四届人大提出的各项战斗任务，夺取社会主义革命和社会主义建设的新胜利。	{'year': '1975', 'genre': 'press reportage', 'name': "People' Daily"}
如橡子、金钢头等野生淀粉已大量用于工业，仅此一项每年可节约粮食四亿多斤；芒杆、龙须草等野生植物，都是造纸的好原料，如果利用这些东西代替木浆造纸，每年可节约木材一百万立方米。	{'year': '1975', 'genre': 'press reportage', 'name': "People' Daily"}
我们及时总结推广了大罗大队党支部的经验，并在这个大队举办了批林批孔展览，组织全县的党员参观学习，对全县基层党组织搞好批林批孔，联系实际对广大党员和群众进行党的基本路线教育，起了很大的促进作用。	{'year': '1975', 'genre': 'press reportage', 'name': "People' Daily"}
“我的新贡献就是证明了下列几点：	{'year': '1975', 'genre': 'press reportage', 'name': "People' Daily"}
许多技术人员以无产阶级专政理论为武器，深入批判林彪鼓吹的唯心论的先验论，批判反动的天才论以及“劳心者治人，劳力者治于人”等孔孟之道，进一步树立起“群众是真正的英雄”和“实践第一”的观点，自觉破除资产阶级法权观念，虚心地接受工人阶级的再教育。	{'year': '1975', 'genre': 'press reportage', 'name': "People' Daily"}
一年多来，先后召开了一百多次批判会，写了三百多篇学习和批判文章，创作了二百多首革命诗歌，出了三十多期大批判专栏，有力地推动了我们大队批林批孔运动普及、深入、持久地发展，促进了农业生产，进一步巩固了集体经济。	{'year': '1975', 'genre': 'press reportage', 'name': "People' Daily"}
发挥商业部门的作用，加强收购工作，是促进“小秋收”的一个重要方面。	{'year': '1975', 'genre': 'press reportage', 'name': "People' Daily"}
干哪一行都是为共产主义加砖添瓦，我一定听从党的安排，党叫干啥就干好啥！”	{'year': '1975', 'genre': 'press reportage', 'name': "People' Daily"}
中共中央政治局委员、国务院副总理李先念、中共中央委员、人大常委会副委员长徐向前，出席了招待会。	{'year': '1975', 'genre': 'press reportage', 'name': "People' Daily"}
由于阶级和阶级斗争的存在，由于资产阶级法权的存在，由于资产阶级思想的腐蚀，除了在小生产者中会产生资本主义之外，在一部分工人中，一部分党员中，一部分国家干部和知识分子中，还可能产生新的资产阶级分子和蜕化变质分子。	{'year': '1975', 'genre': 'press reportage', 'name': "People' Daily"}
有的同志对他说：	{'year': '1976', 'genre': 'press reportage', 'name': "People' Daily"}
他们不去看问题的本质方面，主流方面，而是强调那些非本质方面、非主流方面的东西。	{'year': '1976', 'genre': 'press reportage', 'name': "People' Daily"}
实践证明，在大荣和恒元同志任一把手以来，我们下露河公社的工作不但没有退坡，而且比过去大有起色，这对大家的教育很大。	{'year': '1976', 'genre': 'press reportage', 'name': "People' Daily"}
从此以后，冯文海时时刻刻警惕自己滋长特殊化思想。	{'year': '1976', 'genre': 'press reportage', 'name': "People' Daily"}
乔冠华、李强、郭玉峰、傅传作、谢静宜、王六生、刘振华、向仲华、朱光亚、肖克、吴忠、杨贵、杨俊生、张国权、张积慧、宋时轮、胡炜、唐亮、钱学森、高淑兰、诸惠芬、康林、黄文明、黄作珍、崔修范、谢振华、裴周玉、张耀词、李敏、刘友法、鲁瑛、许健生、莫艾、解力夫、邓岗、李鑫、施义之、陈绍昆、李际泰、李成芳、边疆、汪洋、郭鲁、张劲夫、吴庆彤、张廷发、向守志、黄新廷、吴克华、周一良、魏建功、浩亮、刘庆棠、周培源、田富达、郑屏年、赖奎、宇光、邬吉成、陈树林、曹全夫、任新彦、李新荣、安莉、郭秀琴、杨杭州、陈国亮、马云香、单军、郑毅、李宝志、万其祥、姜金才、张荫华、张洪顺、白淑敏、张其通、丁建基、李金、徐庆文、韩兴连、张和、张秀兰、巩雪芹、刘晋华、张明朝、时述山、张桥松、刘铁成、朱毅鹏、侯亚平、李冬松、车风亭、孙惠香、张秀英、张淑琴、周德福、郎福田、肖洪斌、王信忠、张锡田、潘成礼、郭丽云、李振东、王圈、方成樑。	{'year': '1976', 'genre': 'press reportage', 'name': "People' Daily"}
毛主席的教导，斗争的经验，使杨永海同志坚定了一个决心：	{'year': '1976', 'genre': 'press reportage', 'name': "People' Daily"}
他滔滔不绝地谈的都是贫下中农抗震救灾的英雄事迹，唯独不谈他自己。	{'year': '1976', 'genre': 'press reportage', 'name': "People' Daily"}
欢笑声中，父亲拿出一个红布包，把自己解放雷州时曾经带过的英雄花送给女儿，嘱咐她永远沿着毛主席指引的路走。	{'year': '1976', 'genre': 'press reportage', 'name': "People' Daily"}
开在红花之前的，是贴满校园的火红的决心书。	{'year': '1976', 'genre': 'press reportage', 'name': "People' Daily"}
农场党委书记把医科大学的招生登记表送到婉花手里，婉花接过登记表，同时也接到了家里的信：	{'year': '1976', 'genre': 'press reportage', 'name': "People' Daily"}
目前，台湾无数灾民仍喘息在苦难之中，蒋帮不但没有对他们进行妥善安排，反而假借“救济”之名，正到处伸手要钱，向各界“募捐”。	{'year': '1966', 'genre': 'press reportage', 'name': 'Reference News'}
将军被说成是感到他起了“促进作用”，欧洲关系又开始前进了。	{'year': '1966', 'genre': 'press reportage', 'name': 'Reference News'}
现在在南越的美军十七万人需要给养，同时南越也需要大量物资进口，南越的港口设备已感觉到不够应付。	{'year': '1966', 'genre': 'press reportage', 'name': 'Reference News'}
美军方又立即把威尔逊送进了“左营美军疗养所”“看管”，并伪称威尔逊“因惊惶过度”、“神智不清”，不准高雄“地方检察处”在调查出事经过时，对他进行任何询问；另一方面，又派侵台美军“供应处副处长”泰尔中校和蒋帮有关当局频频密斟、“交换意见”。	{'year': '1966', 'genre': 'press reportage', 'name': 'Reference News'}
在暴雨中，台湾各地许多年久失修的堤防都遭大水冲破。	{'year': '1966', 'genre': 'press reportage', 'name': 'Reference News'}
权威人士估计，美国每年有一千二百人死于急性肝炎。	{'year': '1966', 'genre': 'press reportage', 'name': 'Reference News'}
这个军事代表团将同各个方面的苏联军事当局建立私人接触，将参观一些设施。”	{'year': '1966', 'genre': 'press reportage', 'name': 'Reference News'}
造成台湾这次惨重水灾的原因，固然为天灾之难料，但亦有人谋之不臧。	{'year': '1966', 'genre': 'press reportage', 'name': 'Reference News'}
对北越交通线和军事设备的轰炸，进行了已有十个月了，但是并没有使河内政府软下来。	{'year': '1966', 'genre': 'press reportage', 'name': 'Reference News'}
“美军人员在协定地区内之犯罪案件”，美蒋双方有“共同管辖权时”，“原则上”蒋帮“舍弃管辖权，由美国行使”，如果蒋帮要撤回“舍弃管辖权”，则一定要经“中（蒋帮）美联合委员会”同意。	{'year': '1966', 'genre': 'press reportage', 'name': 'Reference News'}
俄国星期二（六月二十一日）购买了价值八亿美元的加拿大小麦——历史上最大的一次小麦购买量。	{'year': '1966', 'genre': 'press reportage', 'name': 'Reference News'}
在一九六五年二、三月的时候，美国司令部以为只要经过几次警告性的轰炸，北越就会屈服，现在美方人士的态度，和当时的乐观态度相距得很远了。	{'year': '1966', 'genre': 'press reportage', 'name': 'Reference News'}
戴高乐用法语致答词时说，乌克兰和法国之间多年来一直存在着友好关系和尊敬。	{'year': '1966', 'genre': 'press reportage', 'name': 'Reference News'}
以奥共主席穆里为首的党代表团应匈牙利社会主义工人党中央的邀请于二十日到二十二日在匈牙利进行了友好访问。	{'year': '1966', 'genre': 'press reportage', 'name': 'Reference News'}
总统顾问沃尔特·罗斯托今天说，为断定北越对和谈是否真正感兴趣而进行的外交试探，目前正在进入“一个极有意思而微妙的阶段”。	{'year': '1967', 'genre': 'press reportage', 'name': 'Reference News'}
不仅如此，毛主席的这两篇哲学著作还给全世界人民创造了最强大的武器，使他们战胜教条主义和修正主义，推进他们的革命事业。”	{'year': '1967', 'genre': 'press reportage', 'name': 'Reference News'}
美国也认为，以色列军队通过留在××阵地，可以××也门问题的解决办法。	{'year': '1967', 'genre': 'press reportage', 'name': 'Reference News'}
游艺会的演出时间之长，人数的众多，观众情绪的空前热烈，都说明了在香港是史无前例的，为香港的舞台历史划上新的一页，把香港舞台历史带上崭新的时代。	{'year': '1967', 'genre': 'press reportage', 'name': 'Reference News'}
日本亚非团结委员会事务局长板井庄作对东方通讯社记者发表了谈话，指出毛泽东主席在三十年前发表的两篇哲学著作《实践论》和《矛盾论》是帝国主义走向全面崩溃，社会主义走向全世界胜利时代的革命的最高指南。	{'year': '1967', 'genre': 'press reportage', 'name': 'Reference News'}
“毛主席在这两篇著作中发展了、加深了马克思列宁主义的主要组成部分，即辩证唯物论，并把它提高到最高阶段。	{'year': '1967', 'genre': 'press reportage', 'name': 'Reference News'}
香港蒋匪帮报纸今天纷纷就“双十”伪庆发表评论，充分表露它们穷途末路的心境。	{'year': '1967', 'genre': 'press reportage', 'name': 'Reference News'}
古德温称美国对北越的空袭只有不足道的价值，他说，空袭对干扰军队和供应品向南越的渗透几乎没有什么作用。	{'year': '1967', 'genre': 'press reportage', 'name': 'Reference News'}
他说，迄今还没有发生什么事情使得有理由认为河内在作出认真努力以期进行谈判。	{'year': '1967', 'genre': 'press reportage', 'name': 'Reference News'}
这是这个巨大的龙平军火库在三个月略多一点的时间内遭到的第四次袭击。	{'year': '1967', 'genre': 'press reportage', 'name': 'Reference News'}
美国军方发言人在这里说，在发生的最大规模的一次冲突中，越共对西贡东北二十七英里的美国一百七十三伞兵旅据点发射了大约五十一发口径八十一毫米的迫击炮弹。	{'year': '1967', 'genre': 'press reportage', 'name': 'Reference News'}
美国当局今天担心，今天上午使这里附近的一个美国重要的弹药库遭到部分破坏的爆炸和射击，可能是共产党人在春节前展开破坏和恐怖高潮的开始。	{'year': '1967', 'genre': 'press reportage', 'name': 'Reference News'}
如今国府又受了美国的束缚，不得自行反攻大陆，而将坐失良机。	{'year': '1967', 'genre': 'press reportage', 'name': 'Reference News'}
伊朗政府的一项官方声明说，八月三十一日发生的地震大约是在下午两点开始的，它持续了四分多钟。	{'year': '1968', 'genre': 'press reportage', 'name': 'Reference News'}
官方态度仍如约翰逊去年十二月在一次演讲中所说的那样，依然是要由中国方面先修改它的方式，使“它的行径可以让它参加国际大家庭。”	{'year': '1968', 'genre': 'press reportage', 'name': 'Reference News'}
在一些邦内，普通党员甚至不肯屈辱出席他们的邦全会。	{'year': '1968', 'genre': 'press reportage', 'name': 'Reference News'}
极端分子们认为，如果在这个问题上动摇不定，不公开地与“现代修正主义的这支分队的背信弃义的政治和组织的领导”断绝关系，那只会加强它的力量，并且在人民中引起错觉，以为实行共同的领导仍然是可能的，而且会扰乱和破坏正在爆发的革命斗争。	{'year': '1968', 'genre': 'press reportage', 'name': 'Reference News'}
例如七月二十三日国营报纸《劳动人民报》上刊载了一篇投书说：	{'year': '1968', 'genre': 'press reportage', 'name': 'Reference News'}
同最近宣布的损失数字比数，到八月十四日为止的那个星期为大约三十五万英镑，到八月八日为止的那个星期为大约四百二十万英镑。	{'year': '1968', 'genre': 'press reportage', 'name': 'Reference News'}
该市剩下的五家肥皂工厂，两个月内也将缺乏原料而关闭。	{'year': '1968', 'genre': 'press reportage', 'name': 'Reference News'}
在希布伦市政大厅，一千人举行集会，抗议八十名犹太人在这个城市定居。	{'year': '1968', 'genre': 'press reportage', 'name': 'Reference News'}
在内河航运方面，自六月底武装护航的“巴英兰”号轮船受到人民武装力量袭击之后；接着在七月四日，自毛淡棉开出的“波漂拉逊”号和自仰光开出的“瑞欣达”号机帆船在丹那沙林行政区的土瓦县浪弄岛和申摩镇之间被人民武装截击，人民武装缴获政府贸易局大量物资。	{'year': '1968', 'genre': 'press reportage', 'name': 'Reference News'}
印共（马）新修正主义领导集团采取非马克思主义的和不民主的方法来镇压各邦全会上广泛出现的对当权的一派的路线的反叛，这种做法已使布德万中央全会丧失了它的意义，如果它有什么意义的话。	{'year': '1968', 'genre': 'press reportage', 'name': 'Reference News'}
他将于二十五日回国。	{'year': '1968', 'genre': 'press reportage', 'name': 'Reference News'}
在喀拉拉邦，他们使用各种阴谋诡计，并利用邦政府机器来压制共产党员。	{'year': '1968', 'genre': 'press reportage', 'name': 'Reference News'}
以色列的一位发言人今天在这里说，以色列已经对美国说，为了保卫以色列安全的利益，它的军队正占领着位于亚喀巴湾口的蒂朗岛，直到通过谈判实现和平解决时为止。	{'year': '1968', 'genre': 'press reportage', 'name': 'Reference News'}
为了组织贝尔格莱德会议而进行的一系列协商表明，在不结盟国家之间对于一些问题，甚至对于它们聚集一起的方式，也有不同的看法。	{'year': '1969', 'genre': 'press reportage', 'name': 'Reference News'}
随着苏联对阿尔及利亚的援助增加，苏联在那个国家的专家人数也增加了。	{'year': '1969', 'genre': 'press reportage', 'name': 'Reference News'}
它还将有助于分析紫外线、伽马和爱克斯射线，这只有完全在地球大气外面才能做到。	{'year': '1969', 'genre': 'press reportage', 'name': 'Reference News'}
但中苏两国都认为这个条约是中苏两国人民所缔结的“宝贵的誓约”。	{'year': '1969', 'genre': 'press reportage', 'name': 'Reference News'}
按我个人的意见，在可以预料的将来发生中苏全面战争的可能性是非常小的，但是象乌苏里江那样的小冲突今后也还会有的，而且在不发展为大冲突的范围内，由苏联首先发动更大的冲突乃至引起战火的可能性也不是没有的。	{'year': '1969', 'genre': 'press reportage', 'name': 'Reference News'}
由于阿拉伯—以色列冲突所造成的政治上的一致态度使得苏联对石油分配可以施加更大的影响。	{'year': '1969', 'genre': 'press reportage', 'name': 'Reference News'}
示威者举着大红旗，抬着毛主席的画像。	{'year': '1969', 'genre': 'press reportage', 'name': 'Reference News'}
今天上午，我没有遇到什么麻烦就通过一个侧门进入了苏联大使馆，在使馆里，外交官和工作人员们在准备受到难以预料会持续多久的围困。	{'year': '1969', 'genre': 'press reportage', 'name': 'Reference News'}
其它计划中的观察包括研究爱克斯射线、伽马射线和高频率紫外线，这个观察站配备有两架望远镜和辐射侦察器。	{'year': '1969', 'genre': 'press reportage', 'name': 'Reference News'}
在北京的外侨区，供应外交人员的商店今天贴了反苏标语和漫画，顾客们——主要是东方集团外交人员——在接过他们买的香肠、面包和鱼子酱时，还得到反苏传单。	{'year': '1969', 'genre': 'press reportage', 'name': 'Reference News'}
“尽管我多次向人们的良知发出呼吁，尽管现任领导人为了建立我军士兵、军士和军官之间坦率的建设性的对话而表示的一切善意，由于七月三十一日运动而出了狱、或者由于全国革命委员会的支持而取得职位和官阶的一些阴险分子，一些怯懦的不可救药分子，却进行骚动，到处诋毁领导人，千方百计损害人民和革命”。	{'year': '1969', 'genre': 'press reportage', 'name': 'Reference News'}
示威群众高呼口号，抗议在莫斯科中国使馆外面发生的事件，特别是侮辱毛主席的事件，据认为这种行动是苏联领导搞的新的反华事件。	{'year': '1969', 'genre': 'press reportage', 'name': 'Reference News'}
示威者在大门前停下来，举行抗议声讨会，然后离开，让其他队伍在那里进行抗议活动。	{'year': '1969', 'genre': 'press reportage', 'name': 'Reference News'}
“泰国人民之声”电台二十七日广播一篇文章，热烈欢呼中国人民在战无不胜的毛泽东思想指引下，取得社会主义建设的伟大胜利。	{'year': '1970', 'genre': 'press reportage', 'name': 'Reference News'}
现在，中国站在亚洲反美爱国统一战线的中心，越来越受到亚洲和全世界的战斗人民的信任，它没有辜负这一信任。	{'year': '1970', 'genre': 'press reportage', 'name': 'Reference News'}
进行基本建设和奖励农村工业的结果，不但促进了战备，而且提高了农村的生活水平。	{'year': '1970', 'genre': 'press reportage', 'name': 'Reference News'}
公报高度评价了“革命”的成果，说“整个经济战线形势很好”，还说农业丰收，工业生产和基本建设发展的速度很快；同时宣布，国务院作了关于“全国计划会议和一九七○年国民经济计划”的报告。	{'year': '1970', 'genre': 'press reportage', 'name': 'Reference News'}
我们希望同所有各国人民一样，在属于我们的巴勒斯坦领土上，我们有自决权。	{'year': '1970', 'genre': 'press reportage', 'name': 'Reference News'}
其它特效药虽然也有这种作用，却会把正常的细胞也摧毁了的。	{'year': '1970', 'genre': 'press reportage', 'name': 'Reference News'}
现中美双方已签订一项中美抗癌合作研究计划，与美国纽约科学院和马萨诸塞州理工学院的有关研究所，及美国国家癌症研究中心和国家公共卫生研究院等单位，共同推动此一工作的进展。	{'year': '1970', 'genre': 'press reportage', 'name': 'Reference News'}
是否要使所有的难民在帐篷里都产生失望？	{'year': '1970', 'genre': 'press reportage', 'name': 'Reference News'}
同时，莫斯科没有任何信号表明，克里姆林宫放弃了它一再说的共产主义运动对世界的控制。	{'year': '1970', 'genre': 'press reportage', 'name': 'Reference News'}
政府决定全面推展一项中药植物药材抗癌科学研究的工作。	{'year': '1970', 'genre': 'press reportage', 'name': 'Reference News'}
同时，同西德签署的条约旨在消除苏联集团西侧可能存在的麻烦，同时莫斯科在中东和地中海地区谋求帝国主义的目标。	{'year': '1970', 'genre': 'press reportage', 'name': 'Reference News'}
俄国人有他们自己的学校、体育俱乐部，甚至每天晚上都放电影，在卢克苏尔寺院废墟或者在开罗的一个博物馆，经常可以看见穿便服的俄国人，并且通常是四五个人一群，专心研究旅行指南。	{'year': '1970', 'genre': 'press reportage', 'name': 'Reference News'}
在爬上“带电”铁塔的时候，甚至还没有进到“禁区”，中国工人的手上和脚上就放出火花。	{'year': '1970', 'genre': 'press reportage', 'name': 'Reference News'}
他们冲破了美帝、苏修和各国反动派的经济封锁，发明和创造了许多新产品、新技术、新工艺。	{'year': '1970', 'genre': 'press reportage', 'name': 'Reference News'}
日本有名的电器厂商“日本电子”公司新研制成功一种医疗仪器，系专用于检查身体的制品——“Ｊ１Ｄ型高速紫外线摄影机”。	{'year': '1970', 'genre': 'press reportage', 'name': 'Reference News'}
《纽约时报》今天恢复了刊登关于五角大楼秘密文件的连载文章，它说，这个研究报告表明，约翰·肯尼迪总统把艾森豪威尔政府所进行的“冒有限风险的赌博”变为“承担广泛的义务”来阻止共产党控制南越。	{'year': '1971', 'genre': 'press reportage', 'name': 'Reference News'}
对共产主义的经济政策的一个完全没有听说过的奇闻是，工业消费品的进口比例完全失去平衡。	{'year': '1971', 'genre': 'press reportage', 'name': 'Reference News'}
苏共中央和苏联政府已通过了补充刺激措施，以便完成或超额完成计划规定的收购量。	{'year': '1971', 'genre': 'press reportage', 'name': 'Reference News'}
这个行动预示，具体地对兰德公司在华盛顿和加利福尼亚州圣莫尼卡的办事处的保密措施将加严，但是五角大楼的官员们说，这样的结果很可能会对存放保密材料的非政府机构加严保密情报的保护，和加强保密检查。	{'year': '1971', 'genre': 'press reportage', 'name': 'Reference News'}
在北越上空的空战再次成为文章中的一个问题。	{'year': '1971', 'genre': 'press reportage', 'name': 'Reference News'}
“我们去安曼的目的是为了设法制止在约旦的阿拉伯人流血，使所有的枪炮都对准敌人以色列。”	{'year': '1971', 'genre': 'press reportage', 'name': 'Reference News'}
在东巴基斯坦没有成立一个叛逆者的明显的临时政府的情况下，这是俄国在承认穆吉布尔是那里的统治者方面所能做的最大限度了。	{'year': '1971', 'genre': 'press reportage', 'name': 'Reference News'}
南《政治报》六月十一日刊登了南通社驻苏记者诺瓦契奇的一篇报道，题为《莫斯科市场上的物价》，摘要如下：	{'year': '1971', 'genre': 'press reportage', 'name': 'Reference News'}
据《人民自由报》的消息，由于实行经济改革而减少国家资助，房租的剧增就是不可避免的了，同时，人民很难同意这种理由，并如去匈牙利的旅行者所报道的那样，大骂卡达尔政权。	{'year': '1971', 'genre': 'press reportage', 'name': 'Reference News'}
在完成了由共产党东德进行的、包括政治学习在内的为期九个月的训练计划以后，埃及的一支新的警察部队在今年早些时候出现在开罗了。	{'year': '1971', 'genre': 'press reportage', 'name': 'Reference News'}
《纽约时报》的文章说，“五角大楼的分析报告撰写者说，虽然肯尼迪先生抵抗住了要求把美国地面作战部队投入南越的压力，但是他采取了一系列行动，大大扩大了美国在军事上和政治上卷入南越的程度，可是不管怎么说，给林登·约翰逊总统留下的局面同肯尼迪先生继承下来的局面同样糟糕。”	{'year': '1971', 'genre': 'press reportage', 'name': 'Reference News'}
尼克松对北越采取了行动，特别是采取了轰炸和在港口布雷的做法，而这是约翰逊所不敢干的事。	{'year': '1972', 'genre': 'press reportage', 'name': 'Reference News'}
一方面呼吁世间和平，一方面又投下这些炸弹——这是一桩奇怪的事情。	{'year': '1972', 'genre': 'press reportage', 'name': 'Reference News'}
国际大家庭在这种结局面前所表现出无能为力和一些大国甚至推波逐澜，深刻地说明了，各种类型的不择手段的手法（穷国家的不择手段的手法和富国家的不择手段的手法）在国际舞台上所起的和将继续起的作用。	{'year': '1972', 'genre': 'press reportage', 'name': 'Reference News'}
雄花上的糖浆不能吸引蜜蜂往作物上飞，其作用相当于普通糖浆。	{'year': '1972', 'genre': 'press reportage', 'name': 'Reference News'}
古宾教授提出采用茴香油、薄荷油等等挥发油类强刺激剂，使雄花糖浆具有稳定的香味。	{'year': '1972', 'genre': 'press reportage', 'name': 'Reference News'}
只有一点是明确的，那就是：	{'year': '1972', 'genre': 'press reportage', 'name': 'Reference News'}
历届总统和国会在这些条约中承认，在欧洲和亚洲保持力量均势对我们都有着永久的利害关系。	{'year': '1972', 'genre': 'press reportage', 'name': 'Reference News'}
如果说重新统一是我国人民十分坚定的愿望，那末这就是我所说的这个重新统一。	{'year': '1972', 'genre': 'press reportage', 'name': 'Reference News'}
由于美国兵的逐渐撤退，印度支那战争变得不太是美国的战争了，但是，战斗仍在继续，因此，正如新近对北越的轰炸所表明的那样，美国仍然没有减少牵连。	{'year': '1972', 'genre': 'press reportage', 'name': 'Reference News'}
法国《快报》三月二十至二十六日一期刊载了一篇文章，题为《巴泽尔先生对＜快报＞的谈话》，摘要如下：	{'year': '1972', 'genre': 'press reportage', 'name': 'Reference News'}
美国的侦察飞机一直观察着它们，五角大楼人士说，集结的船只已部分散开了。	{'year': '1972', 'genre': 'press reportage', 'name': 'Reference News'}
估计田中一周会谈时可以达成日中邦交正常化，但台湾问题的处理将是那以后最重要的课题。	{'year': '1972', 'genre': 'press reportage', 'name': 'Reference News'}
五角大楼人士说，人们认为这种事态发展可能确凿地表明，俄国人不会试图在海上显示力量或采取其它军事行动来压美国拆除在北越的海上的水雷壁垒。	{'year': '1972', 'genre': 'press reportage', 'name': 'Reference News'}
如果我们这样做，我相信，一定会把我们在东南亚承担的义务看作是我们的利益以及同样谋求亚洲稳定与和平的一切人的利益的一个重要组成部分。	{'year': '1972', 'genre': 'press reportage', 'name': 'Reference News'}
如一九五八年以来的中苏关系的历史所表明的，决定在核事务方面单干会使盟国和朋友变成劲敌。	{'year': '1972', 'genre': 'press reportage', 'name': 'Reference News'}
今天轮到同共产党中国建立外交关系，人们认为，西班牙不久将和东方国家签订外交协定了。	{'year': '1973', 'genre': 'press reportage', 'name': 'Reference News'}
据一项情报估计，近数月来，至少有一千五百辆俄国的新式Ｔ—６２坦克已到达东德和捷克斯洛伐克。	{'year': '1973', 'genre': 'press reportage', 'name': 'Reference News'}
这些财长后来还会见了美国副财政部长沃尔克。	{'year': '1973', 'genre': 'press reportage', 'name': 'Reference News'}
广泛传播的非官方的消息说，德国人和日本人现在都准备考虑就全面调整世界货币问题举行较广泛的会谈，其中包括代价很高的为德国马克和日圆规定新的兑换率问题和美元贬值问题。	{'year': '1973', 'genre': 'press reportage', 'name': 'Reference News'}
磋商的结果决定，十二日对中国方面发出“表示衷心欢迎，将以全国性规模欢迎”的内容的信件，同时，还要广泛地向除政府和共产党以外的政界、经济界、劳动界等方面发出呼吁，成立欢迎委员会。	{'year': '1973', 'genre': 'press reportage', 'name': 'Reference News'}
西德电台援引西方军事专家的话说，目一九七一年初以来，坦克的数量增加了三千辆，大炮增加了一千门，装甲车增加了一千辆。	{'year': '1973', 'genre': 'press reportage', 'name': 'Reference News'}
认为，“日本经济象是高速巨型航船一样地飞跑，因而很清楚，转变方向是需要时间和距离的”，但又认为，“按日本方面说明的那样在数字上改善日美间的不平衡，是没有保证的”。	{'year': '1973', 'genre': 'press reportage', 'name': 'Reference News'}
政府方案和历来一样是一个刺激经济的超级大规模的预算，把要重建异常的经济形势的想法等等都完全忘却了。”	{'year': '1973', 'genre': 'press reportage', 'name': 'Reference News'}
波恩财政部负责货币事务的国务秘书波尔今天说，西德外汇市场今天仍然关闭，这是连续第二天关闭，但是，他的这个讲话是在英国财政部宣布伦敦外汇市场将于今天重新开市的消息之前发表的。	{'year': '1973', 'genre': 'press reportage', 'name': 'Reference News'}
美《洛杉矶时报》二月五日刊登发自维也纳的一篇报道，题目是《当削减军事力量的会谈开始时，有消息说苏联的坦克增加了》，摘要如下：	{'year': '1973', 'genre': 'press reportage', 'name': 'Reference News'}
四派方面澄清说，“正是由于政局处在重大关头，才为了鼓舞田中内阁而巩固团结，这有什么坏处”，但是，四派当中的中曾根、三木两派也有少数人担心“不稳妥”。	{'year': '1973', 'genre': 'press reportage', 'name': 'Reference News'}
在联合国之外召开安理会会议的全体委员会负责研究组织这些会议的实际问题和财政技术问题。	{'year': '1973', 'genre': 'press reportage', 'name': 'Reference News'}
在问到埃及和伊拉克的关系时，总统回答说，我同任何一个阿拉伯国家都绝无纠纷，因为基础是团结和合作，我已给伊拉克总统贝克尔写了一封信，以消除我们关系中的误解，现在我有一名特使带了另一封信在伊拉克，我们之间有经济方面的谅解，从根本上说我们是互相合作和谅解的。	{'year': '1974', 'genre': 'press reportage', 'name': 'Reference News'}
两国今天发表了一项关于巴勒斯坦问题的声明，这项声明虽然具有协议的调子，但却允许双方保留其现行政策的微妙之处。	{'year': '1974', 'genre': 'press reportage', 'name': 'Reference News'}
但是我们要讨论所有问题”，不只是石油问题。	{'year': '1974', 'genre': 'press reportage', 'name': 'Reference News'}
最近，也正出现苏埃关系趋于恢复的迹象；苏联以恢复日内瓦中东和平会议为目标，摆开架势要开展积极的外交攻势。	{'year': '1974', 'genre': 'press reportage', 'name': 'Reference News'}
在回答一个关于巴勒斯坦问题的提问时，总统说两年来我建议组成一个巴勒斯坦临时政府，要是这个政府组成了的话，它已成为巴勒斯坦人民的唯一代表，十月六日后世界已承认它了。	{'year': '1974', 'genre': 'press reportage', 'name': 'Reference News'}
三分之一用于自己和其他阿拉伯国家的发展，三分之一投资于先进国家，而其余三分之一投资于发展中国家。	{'year': '1974', 'genre': 'press reportage', 'name': 'Reference News'}
阿提基有力地发挥了下面这个议题，即西方在价格方面施加的新压力和剩余资金的回流产生了料想不到的不利后果，即，把这场辩论变成一场爆炸性的政治斗争，而西方的目的是削减第三世界产油国的主权，并使它们回到阿提基所说的“超级富人”的仆从的地位。	{'year': '1974', 'genre': 'press reportage', 'name': 'Reference News'}
但是，外交官们研究了过去五天来的祝酒词、声明和公报以后，发现双方有一个共同的愿望，那就是为了达成广泛的目标协议而把双方在中东战略某些具体问题上的分歧搁置一边。	{'year': '1974', 'genre': 'press reportage', 'name': 'Reference News'}
南朝鲜政府二十六日正式要求日本引用其合法权力镇压反汉城的这个“反动”组织，这个要求已被田中角荣首相含蓄地拒绝。	{'year': '1974', 'genre': 'press reportage', 'name': 'Reference News'}
约有一万五千名南朝鲜人今天举行反日示威，同时警方在接到用炸弹爆炸的威胁后，在日本大使馆和商号周围加强了保安工作。	{'year': '1974', 'genre': 'press reportage', 'name': 'Reference News'}
这家报纸今天刊载的一则从华盛顿发出的消息说，这项向沙特阿拉伯增加出售武器的秘密计划显然是由国务卿基辛格制订的。	{'year': '1974', 'genre': 'press reportage', 'name': 'Reference News'}
如果他们要求重新讨论价格问题，我们准备进行合理的讨论。	{'year': '1974', 'genre': 'press reportage', 'name': 'Reference News'}
从年龄来看，不能设想现在的领导人在明年的党代表大会以后还会保留其地位四、五年。	{'year': '1975', 'genre': 'press reportage', 'name': 'Reference News'}
这可能是最严重地违反限制战略武器会谈所达成的协议的行为，特别是鉴于勃列日涅夫和福特去年十一月份临时达成的协议第一次把分导式多弹头运载工具列入受限制的战略武器中。	{'year': '1975', 'genre': 'press reportage', 'name': 'Reference News'}
在发展国民经济的过程中，应该也有必要加强团结，平等互利，互通有无，互相支援。	{'year': '1975', 'genre': 'press reportage', 'name': 'Reference News'}
“在英国的安全丝毫不受威胁的情况下进行这种试验在该国公众中引起了理所当然的疑惑。”	{'year': '1975', 'genre': 'press reportage', 'name': 'Reference News'}
勃列日涅夫近几个月来利用几乎每一个公开的机会告诫人们注意中东的战事有再起的危险，明白无误地批评基辛格的个人外交，主张重开日内瓦会议。	{'year': '1975', 'genre': 'press reportage', 'name': 'Reference News'}
联系到这一点，伦斯再次指责华沙条约组织说，东方毫无疑问在进行迄今规模的演习，但它至今还没有根据赫尔辛基最后文件的规定通报过一次军事演习。	{'year': '1975', 'genre': 'press reportage', 'name': 'Reference News'}
对国防计划人员来说，除了直接从美国本土采取军事行动之外，岛屿往往是唯一的选择。	{'year': '1975', 'genre': 'press reportage', 'name': 'Reference News'}
总统拒绝了参议院少数党领袖斯科特和参议院多数党领袖曼斯菲尔德提出的这一建议：	{'year': '1975', 'genre': 'press reportage', 'name': 'Reference News'}
由于基辛格国务卿的外交活动，美中关系按照一九七二年二月尼克松访华时发表的上海公报的方针在向前发展，福特访华的成果如何将引人注目。	{'year': '1975', 'genre': 'press reportage', 'name': 'Reference News'}
但是，美国情报部门发现，苏联人正在他们国家的其他地区试验经过改装的“萨姆—５粗毛犬式”地对空导弹。	{'year': '1975', 'genre': 'press reportage', 'name': 'Reference News'}
自那以后，北京在讲话中攻击莫斯科时只称它为另一个“超级大国”，虽然这指的是谁始终是十分清楚的，但是苏联集团的使节一直继续坐在他们的座位上。	{'year': '1975', 'genre': 'press reportage', 'name': 'Reference News'}
马科斯总统是菲律宾三十年来访华的第一位元首，此行主旨为了签署中菲建交的联合声明，并选定本月十二日菲律宾独立纪念日宣布，这更可看出其中包含重大意义，说明了菲律宾政府和人民对独立自主和对中国友谊的珍视，而且也表现了促进两国密切合作的真挚诚意。	{'year': '1975', 'genre': 'press reportage', 'name': 'Reference News'}
当他在特拉维夫机场向拉宾总理告别时，他声音呜咽地说，他的努力“除了能使这个地区的青年人在不用担心发生战争的情况下成长外没有其他目的”。	{'year': '1975', 'genre': 'press reportage', 'name': 'Reference News'}
马克思列宁主义的建党理论；建立以工农联盟为基础的统一战线和确立无产阶级的领导权的问题；关于无产阶级专政的理论；根据人民战争的战略战术的丰富实践，创造性地建立和发展了其理论，等等。	{'year': '1976', 'genre': 'press reportage', 'name': 'Reference News'}
我们批准了在那里联合生产军用飞机。	{'year': '1976', 'genre': 'press reportage', 'name': 'Reference News'}
不仅从中国历史角度来看，而且从整个亚洲的历史角度来看，毛主席作出的一个伟大贡献，就是他使欧洲的马克思主义具有了亚洲形态。	{'year': '1976', 'genre': 'press reportage', 'name': 'Reference News'}
日本共产党（左派）中央机关报《人民之星》九月十六日发表社论，题为《认真学习毛泽东思想》，副题为《毛泽东同志永垂不朽》，摘要如下：	{'year': '1976', 'genre': 'press reportage', 'name': 'Reference News'}
首先，从基辛格的角度来看，它使得基辛格在最需要对莫斯科施加有效压力的时候却无法施加那么多的有效压力，因而阻碍了他争取缓和的全盘努力。	{'year': '1976', 'genre': 'press reportage', 'name': 'Reference News'}
毛泽东同志和中国共产党，把受外国帝国主义和国内反动派的多年统治，从而使在绝大多数人处于文盲状态的中国人民，用马克思列宁主义的思想进行教育，并领导他们站了起来，成功地推进了这一艰巨的事业，在意识形态领域里，也划时代地发展了马克思列宁主义理论，使历史唯物主义同辩证唯物主义与人民革命斗争结合并有了发展，在整个活动中使群众观点和群众路线具体化，把马克思主义的艺术文化的理论系统化，正确地确定了它在革命事业中的位置，从而创造性地发挥了它的战斗力，丰富了马克思列宁主义的理论宝库。	{'year': '1976', 'genre': 'press reportage', 'name': 'Reference News'}
我们特别希望……	{'year': '1976', 'genre': 'press reportage', 'name': 'Reference News'}
这些就是某些高级领导人要把自己的子女或孙子孙女送进去的地方，他们经常通过走后门使入学考试时的不及格分数变成了“成绩优秀”。	{'year': '1976', 'genre': 'press reportage', 'name': 'Reference News'}
有些机构，诸如新闻社或“美国加拿大研究所”已成了尽人皆知的新贵们安插他们的子女的地方。	{'year': '1976', 'genre': 'press reportage', 'name': 'Reference News'}
这是自己给自己造成的创伤，它停止了当使美中关系保持持续的势头而非常需要的血液，因而妨碍我们进一步试探那些正在展现的可能性。	{'year': '1976', 'genre': 'press reportage', 'name': 'Reference News'}
只要中美上海公报的各项原则能够认真执行，两国关系就可以继续得到改善。	{'time': '1975', 'genre': 'others', 'work': "Chinese government's report"}
他们连中苏边界存在着争议地区都不承认，连双方武装力量在边界争议地区脱离接触、防止武装冲突这样的事情都不干，却侈谈什么互不使用武力、互不侵犯的空洞条约，这除了为着欺骗苏联人民和世界舆论以外，还有什么呢？	{'time': '1975', 'genre': 'others', 'work': "Chinese government's report"}
要依靠广大群众，稳、准、狠以准为重点地打击一小撮阶级敌人。	{'time': '1975', 'genre': 'others', 'work': "Chinese government's report"}
我们党的第十次全国代表大会，再一次阐明了毛主席制定的党在整个社会主义历史阶段的基本路线和政策，进一步指明了无产阶级专政下继续革命的方向。	{'time': '1975', 'genre': 'others', 'work': "Chinese government's report"}
我们要在一九七五年完成和超额完成第四个五年计划，这样就可以为在一九八○年以前实现上述的第一步设想打下更牢固的基础。	{'time': '1975', 'genre': 'others', 'work': "Chinese government's report"}
我们奉劝苏联领导，还是老老实实坐下来谈判，解决一点问题，不要再玩弄那些骗人的花招了。	{'time': '1975', 'genre': 'others', 'work': "Chinese government's report"}
英雄的人民解放军担负着保卫祖国的光荣任务。	{'time': '1975', 'genre': 'others', 'work': "Chinese government's report"}
苏联社会帝国主义是声东击西。	{'time': '1975', 'genre': 'others', 'work': "Chinese government's report"}
工、农、商、学、兵、政、党这七个方面，党是领导一切的。	{'time': '1975', 'genre': 'others', 'work': "Chinese government's report"}
各位代表！	{'time': '1975', 'genre': 'others', 'work': "Chinese government's report"}
要全心全意依靠工人阶级、贫下中农，团结其他劳动群众和广大知识分子，进一步发展工人阶级领导的以工农联盟为基础的包括爱国民主党派、爱国人士、爱国侨胞和港澳同胞的革命统一战线。	{'time': '1975', 'genre': 'others', 'work': "Chinese government's report"}
我们要在党的领导下，加强各级革命委员会的建设。	{'time': '1975', 'genre': 'others', 'work': "Chinese government's report"}
我们要严格区分和正确处理两类不同性质的矛盾，认真落实党的各项政策，把巩固无产阶级专政的任务落实到基层。	{'time': '1975', 'genre': 'others', 'work': "Chinese government's report"}
我们愿意在和平共处五项原则的基础上同一切国家建立和发展关系。	{'time': '1975', 'genre': 'others', 'work': "Chinese government's report"}
国务院将按照这个目标制订十年长远规划、五年计划和年度计划。	{'time': '1975', 'genre': 'others', 'work': "Chinese government's report"}
国家的统一，人民的团结，国内各民族的团结，这是我们的事业必定要胜利的基本保证。	{'time': '1975', 'genre': 'others', 'work': "Chinese government's report"}
同我国建立外交关系的国家增加到近百个，有经济贸易关系和文化往来的国家和地区达到一百五十多个。	{'time': '1975', 'genre': 'others', 'work': "Chinese government's report"}
社会主义革命是使社会生产力发展的强大推动力。	{'time': '1975', 'genre': 'others', 'work': "Chinese government's report"}
我们粉碎了帝国主义、社会帝国主义的包围、封锁、侵略和颠覆，加强了同各国人民特别是第三世界各国人民的团结。	{'time': '1975', 'genre': 'others', 'work': "Chinese government's report"}
我们必须发扬遵守纪律的光荣传统，认真执行民主集中制，在毛主席革命路线的基础上统一认识，统一政策，统一计划，统一指挥，统一行动。	{'time': '1975', 'genre': 'others', 'work': "Chinese government's report"}
我们应当继续努力，发扬成绩，克服缺点，谦虚谨慎，戒骄戒躁，乘胜前进。	{'time': '1975', 'genre': 'others', 'work': "Chinese government's report"}
不论是战争引起革命，还是革命制止战争，国际形势总是朝着有利于人民的方向发展，世界的前途总是光明的。	{'time': '1975', 'genre': 'others', 'work': "Chinese government's report"}
我国在联合国长期被非法剥夺的席位得到恢复。	{'time': '1975', 'genre': 'others', 'work': "Chinese government's report"}
我们愿意同日本政府和人民一起，在中日联合声明的基础上，为增进两国友好睦邻关系而努力。	{'time': '1975', 'genre': 'others', 'work': "Chinese government's report"}
实现这个任务的关键，就是要刻苦攻读马列著作和毛主席著作，使广大干部和群众用马克思主义的基本理论武装起来。	{'time': '1975', 'genre': 'others', 'work': "Chinese government's report"}
国内外反动派曾经断言，无产阶级文化大革命定会破坏我国国民经济的发展，现在事实已经给了他们有力的回答。	{'time': '1975', 'genre': 'others', 'work': "Chinese government's report"}
中美两国之间存在着根本分歧。	{'time': '1975', 'genre': 'others', 'work': "Chinese government's report"}
要认真办好民兵。	{'time': '1975', 'genre': 'others', 'work': "Chinese government's report"}
经过文化大革命和批林批孔运动的锻炼，我国各族人民更加团结，我们的军队更加坚强，我们的伟大祖国更加巩固。	{'time': '1975', 'genre': 'others', 'work': "Chinese government's report"}
我们超额完成了第三个五年计划，第四个五年计划一九七五年也将胜利完成。	{'time': '1975', 'genre': 'others', 'work': "Chinese government's report"}
在这十年中，我们依靠自己的力量，建成了一千一百个大中型项目，成功地进行了氢弹试验，发射了人造地球卫星。	{'time': '1975', 'genre': 'others', 'work': "Chinese government's report"}
老中青三结合的革命委员会密切了和群众的联系，大批的无产阶级革命事业接班人茁壮成长，以革命样板戏为标志的无产阶级文艺革命深入发展，教育卫生革命生气勃勃，广大干部和工农兵学商坚持五七道路，上百万赤脚医生成长起来，近千万知识青年上山下乡，工农兵参加的马克思主义理论队伍正在壮大。	{'time': '1975', 'genre': 'others', 'work': "Chinese government's report"}
各国人民对此必须有所准备。	{'time': '1975', 'genre': 'others', 'work': "Chinese government's report"}
全国解放以来，尽管我国人口增加百分之六十，但粮食增产一点四倍，棉花增产四点七倍。	{'time': '1975', 'genre': 'others', 'work': "Chinese government's report"}
我们要团结百分之九十五以上的干部和群众，团结一切可以团结的力量，为建设伟大的社会主义祖国而共同奋斗。	{'time': '1975', 'genre': 'others', 'work': "Chinese government's report"}
第一步，用十五年时间，即在一九八○年以前，建成一个独立的比较完整的工业体系和国民经济体系；第二步，在本世纪内，全面实现农业、工业、国防和科学技术的现代化，使我国国民经济走在世界的前列。	{'time': '1975', 'genre': 'others', 'work': "Chinese government's report"}
这条路线，使我们战胜了帝国主义的封锁，顶住了社会帝国主义的压力，任凭资本主义世界经济危机风潮起伏，我国经济始终扎实地蓬勃发展。	{'time': '1975', 'genre': 'others', 'work': "Chinese government's report"}
在毛主席为首的党中央领导下，我国人民奋发图强，战胜种种艰难险阻，只用了二十多年的时间，就把一个贫穷落后的国家变成初步繁荣昌盛的社会主义国家。	{'time': '1975', 'genre': 'others', 'work': "Chinese government's report"}
我们要永远坚持这条路线。	{'time': '1975', 'genre': 'others', 'work': "Chinese government's report"}
中国是一个发展中的社会主义国家，属于第三世界。	{'time': '1975', 'genre': 'others', 'work': "Chinese government's report"}
他们背弃中苏两国总理早在一九六九年就已经达成的谅解，拒绝签订包含有互不使用武力、互不侵犯内容的维持边界现状、防止武装冲突、双方武装力量在边界争议地区脱离接触的协议，致使中苏边界谈判至今没有结果。	{'time': '1975', 'genre': 'others', 'work': "Chinese government's report"}
为了使我国社会主义经济有更大的发展，必须坚持鼓足干劲，力争上游，多快好省地建设社会主义的总路线，继续执行以农业为基础、工业为主导的方针和一系列两条腿走路的政策。	{'time': '1975', 'genre': 'others', 'work': "Chinese government's report"}
我们一定要解放台湾！	{'time': '1975', 'genre': 'others', 'work': "Chinese government's report"}
不论是革命还是建设，都要放手发动群众，大搞群众运动。	{'time': '1975', 'genre': 'others', 'work': "Chinese government's report"}
要通过批林批孔，进一步推动文艺革命、教育卫生革命，推动各条战线的斗批改，支持一切新生事物，更好地坚持社会主义方向。	{'time': '1975', 'genre': 'others', 'work': "Chinese government's report"}
我们的各级领导同志，在抓经济工作的时候，务必十分注意上层建筑领域的社会主义革命，抓紧阶级斗争和路线斗争。	{'time': '1975', 'genre': 'others', 'work': "Chinese government's report"}
台湾同胞和全国人民团结起来，为实现解放台湾、统一祖国的崇高目标而共同努力。	{'time': '1975', 'genre': 'others', 'work': "Chinese government's report"}
“自力更生为主，争取外援为辅，破除迷信，独立自主地干工业、干农业，干技术革命和文化革命，打倒奴隶思想，埋葬教条主义，认真学习外国的好经验，也一定研究外国的坏经验——引以为戒，这就是我们的路线。”	{'time': '1975', 'genre': 'others', 'work': "Chinese government's report"}
从国内国际的形势看，今后的十年，是实现上述两步设想的关键的十年。	{'time': '1975', 'genre': 'others', 'work': "Chinese government's report"}
我们的斗争得到各国人民广泛的同情和支持。	{'time': '1975', 'genre': 'others', 'work': "Chinese government's report"}
它提供了无产阶级专政下继续革命的新经验，具有伟大的历史意义和深远影响。	{'time': '1975', 'genre': 'others', 'work': "Chinese government's report"}
遵照毛主席的指示，三届人大的政府工作报告曾经提出，从第三个五年计划开始，我国国民经济的发展，可以按两步来设想：	{'time': '1975', 'genre': 'others', 'work': "Chinese government's report"}
同资本主义世界经济动荡、通货膨胀的情况相反，我国财政收支平衡，即无外债，又无内债，物价稳定，人民生活逐步改善，社会主义建设欣欣向荣，蒸蒸日上。	{'time': '1975', 'genre': 'others', 'work': "Chinese government's report"}
只有抓好革命，才能搞好生产。	{'time': '1975', 'genre': 'others', 'work': "Chinese government's report"}
我国各族人民要在毛主席为首的党中央领导下，更加紧密地团结起来，坚持党的基本路线和政策，努力实现十大提出的各项战斗任务，巩固和发展无产阶级文化大革命的胜利成果，争取社会主义革命和社会主义建设的新胜利。	{'time': '1975', 'genre': 'others', 'work': "Chinese government's report"}
要按照团结——批评和自我批评——团结的方针，采取民主的方法，认真解决好人民内部矛盾，把广大群众的社会主义积极性充分调动起来。	{'time': '1975', 'genre': 'others', 'work': "Chinese government's report"}
我们同各国人民一道，在反对殖民主义、帝国主义特别是超级大国霸权主义的斗争中，取得了重大胜利。	{'time': '1975', 'genre': 'others', 'work': "Chinese government's report"}
资本主义世界面临战后最严重的经济危机，世界各种基本矛盾进一步激化。	{'time': '1975', 'genre': 'others', 'work': "Chinese government's report"}
新老干部要互相学习，加强团结，要能上能下，坚持参加集体生产劳动，全心全意为人民服务。	{'time': '1975', 'genre': 'others', 'work': "Chinese government's report"}
我们的首要任务，是继续普及、深入、持久地开展批林批孔运动。	{'time': '1975', 'genre': 'others', 'work': "Chinese government's report"}
世界上到处讲缓和、讲和平，恰恰证明，这个世界没有缓和，更谈不上什么持久和平。	{'time': '1975', 'genre': 'others', 'work': "Chinese government's report"}
“深挖洞、广积粮、不称霸”，“备战、备荒、为人民”。	{'time': '1975', 'genre': 'others', 'work': "Chinese government's report"}
苏联领导采取了一系列恶化两国关系的步骤，对我国进行颠覆，直至挑起边界武装冲突。	{'time': '1975', 'genre': 'others', 'work': "Chinese government's report"}
我们要保持过去革命战争时期的那么一股劲，那么一股革命热情，那么一种拚命精神，把革命工作做到底。	{'time': '1975', 'genre': 'others', 'work': "Chinese government's report"}
但是，我们历来认为，这种争论不应妨碍中苏两国正常的国家关系。	{'time': '1975', 'genre': 'others', 'work': "Chinese government's report"}
我们要保持警惕，加强防御，准备打仗。	{'time': '1975', 'genre': 'others', 'work': "Chinese government's report"}
无产阶级文化大革命的胜利，巩固了我国无产阶级专政，促进了社会主义建设，保证了我国站在全世界被压迫人民、被压迫民族一边。	{'time': '1975', 'genre': 'others', 'work': "Chinese government's report"}
我们的一切胜利，都是马克思主义、列宁主义、毛泽东思想的伟大胜利，都是毛主席革命路线的伟大胜利。	{'time': '1975', 'genre': 'others', 'work': "Chinese government's report"}
按照农轻重的次序安排国民经济计划。	{'time': '1975', 'genre': 'others', 'work': "Chinese government's report"}
在我们这样一个近八亿人口的国家，保证了人民吃穿的基本需要。	{'time': '1975', 'genre': 'others', 'work': "Chinese government's report"}
我们支持第二世界国家和人民反对超级大国控制、威胁和欺负的斗争。	{'time': '1975', 'genre': 'others', 'work': "Chinese government's report"}
各级领导班子要提高执行毛主席革命路线的自觉性，更加密切地联系群众。	{'time': '1975', 'genre': 'others', 'work': "Chinese government's report"}
在国家统一计划下，充分发挥中央和地方两个积极性。	{'time': '1975', 'genre': 'others', 'work': "Chinese government's report"}
全军要坚决执行毛主席的建军路线，加强军队建设，加强战备。	{'time': '1975', 'genre': 'others', 'work': "Chinese government's report"}
在文化大革命和批林批孔运动中，各族人民广泛开展学习马克思主义、列宁主义、毛泽东思想的群众运动，提高了阶级斗争和路线斗争觉悟，上层建筑领域的斗批改取得了重大成就。	{'time': '1975', 'genre': 'others', 'work': "Chinese government's report"}
更好地执行鞍钢宪法，深入开展工业学大庆、农业学大寨的群众运动。	{'time': '1975', 'genre': 'others', 'work': "Chinese government's report"}
我们要继续执行毛主席的革命外交路线，着眼于人民，寄希望于人民，把对外工作做得更好。	{'time': '1975', 'genre': 'others', 'work': "Chinese government's report"}
我们决不能因为批林批孔已经取得很大成绩而有所松懈。	{'time': '1975', 'genre': 'others', 'work': "Chinese government's report"}
我们必须坚持抓革命、促生产、促工作、促战备的方针，在革命统帅下，努力增加生产，加快社会主义建设的步伐，使我国社会主义制度的物质基础更加巩固。	{'time': '1975', 'genre': 'others', 'work': "Chinese government's report"}
我们必须坚持从群众中来，到群众中去的群众路线，坚定地相信和依靠群众的大多数。	{'time': '1975', 'genre': 'others', 'work': "Chinese government's report"}
这一切新生事物的涌现，在上层建筑领域加强了无产阶级对资产阶级的全面专政，更有利于巩固和发展社会主义的经济基础。	{'time': '1975', 'genre': 'others', 'work': "Chinese government's report"}
工业总产值一九七四年预计比一九六四年增长一点九倍，主要产品的产量都有大幅度增长，钢增长一点二倍，原煤增长百分之九十一，石油增长六点五倍，发电量增长两倍，化肥增长三点三倍，拖拉机增长五点二倍，棉纱增长百分之八十五，化学纤维增长三点三倍。	{'time': '1975', 'genre': 'others', 'work': "Chinese government's report"}
国务院各部、委，地方各级革命委员会，直到工矿企业和生产队等基层单位，都要发动群众，经过充分讨论，制订自己的计划，争取提前实现我们的宏伟目标。	{'time': '1975', 'genre': 'others', 'work': "Chinese government's report"}
我国农业连续十三年夺得丰收，一九七四年农业总产值预计比一九六四年增长百分之五十一。	{'time': '1975', 'genre': 'others', 'work': "Chinese government's report"}
一方面是美苏两个超级大国争夺世界霸权越来越激烈。	{'time': '1975', 'genre': 'others', 'work': "Chinese government's report"}
它们的争夺遍及世界各个角落，争夺重点在欧洲。	{'time': '1975', 'genre': 'others', 'work': "Chinese government's report"}
无产阶级和资产阶级两个阶级、社会主义和资本主义两条道路、马克思主义和修正主义两条路线的斗争，是长期的，曲折的，有时甚至是很激烈的。	{'time': '1975', 'genre': 'others', 'work': "Chinese government's report"}
当前国际形势的特点，仍然是天下大乱，而且越来越乱了。	{'time': '1975', 'genre': 'others', 'work': "Chinese government's report"}
我们要加强同亚、非、拉国家和人民的团结，坚决支持他们争取和维护民族独立，捍卫国家主权，保护本国资源，发展民族经济的斗争。	{'time': '1975', 'genre': 'others', 'work': "Chinese government's report"}
我们要坚持无产阶级国际主义，同社会主义国家，同全世界被压迫人民、被压迫民族加强团结，互相支援。	{'time': '1975', 'genre': 'others', 'work': "Chinese government's report"}
人民解放军和广大民兵要同全国各族人民一道，随时准备歼灭一切敢于入侵之敌。	{'time': '1975', 'genre': 'others', 'work': "Chinese government's report"}
老太太点着头：	{'time': '1966', 'genre': 'literature', 'category': 'general fiction'}
“没找着领导？”	{'time': '1966', 'genre': 'literature', 'category': 'general fiction'}
可是今天早上，他偏偏把孙子一个人扔在家里了，偏偏就光顾忙着去整理那些被风雨弄倒了的青菜，把孙子给忘了。	{'time': '1966', 'genre': 'literature', 'category': 'general fiction'}
焦振茂说：	{'time': '1966', 'genre': 'literature', 'category': 'general fiction'}
“快找个家伙，把这米倒了。”	{'time': '1966', 'genre': 'literature', 'category': 'general fiction'}
“眼下当然是嫩一点儿，应当让他们在工作里边闯闯。”	{'time': '1966', 'genre': 'literature', 'category': 'general fiction'}
“瞧瞧，我没把话说在后边吧？	{'time': '1966', 'genre': 'literature', 'category': 'general fiction'}
他甚至觉得，这是萧长春作最后挣扎的一种手段。	{'time': '1966', 'genre': 'literature', 'category': 'general fiction'}
焦淑红想把另一张拿出来，掂了掂又放下了。	{'time': '1966', 'genre': 'literature', 'category': 'general fiction'}
“没有，全是路上和交粮食的时候跟这村的人打听的。	{'time': '1966', 'genre': 'literature', 'category': 'general fiction'}
那个人长长地出了口气：	{'time': '1966', 'genre': 'literature', 'category': 'general fiction'}
马之悦不是今天生的，也不是昨天有的，十几年在那儿摆着，谁不了解他？	{'time': '1966', 'genre': 'literature', 'category': 'general fiction'}
他想，东山坞的局势稳住，工作组和王国忠来到的前后一两天里，不再闹出乱子，自己才算过了关。	{'time': '1966', 'genre': 'literature', 'category': 'general fiction'}
韩百安莫名其妙：	{'time': '1966', 'genre': 'literature', 'category': 'general fiction'}
说心里话，我不愿意你赶快找个合适的人吗？	{'time': '1966', 'genre': 'literature', 'category': 'general fiction'}
过去，她怕这个阴森森的老家伙，最近她有了怨恨，恨这个可恶的老家伙怎么不快点儿一挺腿死了，自己好平平安安地过日子。	{'time': '1966', 'genre': 'literature', 'category': 'general fiction'}
唉，他们是打打闹闹、吵吵骂骂的恩爱夫妻，离开久了，心里怪热乎乎的。	{'time': '1966', 'genre': 'literature', 'category': 'general fiction'}
你就让长春给拿拿主意，我看这比什么都保险！”	{'time': '1966', 'genre': 'literature', 'category': 'general fiction'}
“就这芝麻粒大的事儿呀，值得吗？	{'time': '1966', 'genre': 'literature', 'category': 'general fiction'}
怎么协助，又怎么行动，他想了好多道道儿，最后他想到他的闺女。	{'time': '1966', 'genre': 'literature', 'category': 'general fiction'}
“进去吧。”	{'time': '1966', 'genre': 'literature', 'category': 'general fiction'}
更没有金银财宝，谁还能把家给搬走哇？	{'time': '1966', 'genre': 'literature', 'category': 'general fiction'}
他一迈迸狮子院门口，妈妈就告诉他，焦淑红已经找了他三趟，说是把明天接手续的事改在今天了，非常着急，所以，他连屋也没进，把手里的东西往妈妈手里一塞，就急急匆匆地奔到这儿来了。	{'time': '1966', 'genre': 'literature', 'category': 'general fiction'}
志德、志德呀！”	{'time': '1966', 'genre': 'literature', 'category': 'general fiction'}
萧长春在心里掂着这句话，像是自言自语地说：	{'time': '1966', 'genre': 'literature', 'category': 'general fiction'}
人们见他惜花爱草，又说了：	{'time': '1966', 'genre': 'literature', 'category': 'general fiction'}
五婶自任组长，专管大个儿的，陈老太太招呼两个小个儿的。	{'time': '1966', 'genre': 'literature', 'category': 'general fiction'}
说什么呀！	{'time': '1966', 'genre': 'literature', 'category': 'general fiction'}
这不是，都到这节儿上了，还有人想往回拉我们哪，我看那是做梦！	{'time': '1966', 'genre': 'literature', 'category': 'general fiction'}
孙桂英正坐在堂屋奶孩子。	{'time': '1966', 'genre': 'literature', 'category': 'general fiction'}
马立本刚想说：	{'time': '1966', 'genre': 'literature', 'category': 'general fiction'}
韩百安伸着脖子，使劲儿咽了口唾沫，定了定神儿，才把话说出口：	{'time': '1966', 'genre': 'literature', 'category': 'general fiction'}
萧长春说：	{'time': '1966', 'genre': 'literature', 'category': 'general fiction'}
喜老头说：	{'time': '1966', 'genre': 'literature', 'category': 'general fiction'}
这三件事儿都是有关的，像是连环套，一环套一环：	{'time': '1966', 'genre': 'literature', 'category': 'general fiction'}
弯弯绕、马大炮这一伙人老实了，会议上也没出什么岔子，倒是积极分子们在中间起了作用，使得整个会议的气氛一直很热烈。	{'time': '1966', 'genre': 'literature', 'category': 'general fiction'}
韩百仲问：	{'time': '1966', 'genre': 'literature', 'category': 'general fiction'}
果然是一片火热的场景。	{'time': '1966', 'genre': 'literature', 'category': 'general fiction'}
他们一进屋，焦振茂就笑着捅了韩百安一下说：	{'time': '1966', 'genre': 'literature', 'category': 'general fiction'}
“得了，放我这一回吧。	{'time': '1966', 'genre': 'literature', 'category': 'general fiction'}
你甭不承认，谁在背后干了什么，总会有人知道。	{'time': '1966', 'genre': 'literature', 'category': 'general fiction'}
她大步流星地往村外走。	{'time': '1966', 'genre': 'literature', 'category': 'general fiction'}
“焦庆他们到底是缺粮不缺粮啊？”	{'time': '1966', 'genre': 'literature', 'category': 'general fiction'}
小张在屋里应声说：	{'time': '1966', 'genre': 'literature', 'category': 'general fiction'}
马凤兰用挑逗的眼光瞥了孙桂英一眼：	{'time': '1966', 'genre': 'literature', 'category': 'general fiction'}
“你去找找马主任，让他到咱家来一趟……”	{'time': '1966', 'genre': 'literature', 'category': 'general fiction'}
哪会想到，下雨天还有这么多的人出来进去的呢？	{'time': '1966', 'genre': 'literature', 'category': 'general fiction'}
蹲在黑漆门外边的那个人，忽地站起了身，朝马之悦跟前跨了一步，上牙敲着下牙，好一会儿才说出话来：	{'time': '1966', 'genre': 'literature', 'category': 'general fiction'}
马翠清说：	{'time': '1966', 'genre': 'literature', 'category': 'general fiction'}
“明天开会，要有人再挑头提粮食问题，咱们也别顺着他们的意思顶牛了，要压住阵脚，先引着他们商量生产，由生产再联上粮食的事儿，这样就不会乱了。”	{'time': '1966', 'genre': 'literature', 'category': 'general fiction'}
“喂，小乐，你怎么没挑泥去呀？”	{'time': '1966', 'genre': 'literature', 'category': 'general fiction'}
“嗨，怎么都变得迷迷糊糊的了！”	{'time': '1966', 'genre': 'literature', 'category': 'general fiction'}
“他的脑门上有几个紫印儿，真有病还是假有病，我就不知道了。	{'time': '1966', 'genre': 'literature', 'category': 'general fiction'}
“界限、界限！	{'time': '1966', 'genre': 'literature', 'category': 'general fiction'}
动员谁？	{'time': '1966', 'genre': 'literature', 'category': 'general fiction'}
他想；这个哑叭社员，一年三百六十天总是守着羊群，到时候出，到时候归，从来没有迟误过，今天怎么突然不撒羊了呢？	{'time': '1966', 'genre': 'literature', 'category': 'general fiction'}
“真怪。”	{'time': '1966', 'genre': 'literature', 'category': 'general fiction'}
这工夫，两个打麦场上都忙开了扩展场院的事儿，街上没有人，有人也是急急忙忙走过来，又走过去，没空儿到院子里看看，或者说句话儿。	{'time': '1966', 'genre': 'literature', 'category': 'general fiction'}
“支书说，这会儿正是火候，一说保证能说动她，咱们试试去，行不行？”	{'time': '1966', 'genre': 'literature', 'category': 'general fiction'}
这一层高大、宽敞的大殿，经过老保管带着几个会木匠活的、泥水活的社员三天修整和打扫，已经是面貌一新了。	{'time': '1966', 'genre': 'literature', 'category': 'general fiction'}
“看你，说这种话，让人家听见多笑话呀！”	{'time': '1966', 'genre': 'literature', 'category': 'general fiction'}
这边货架子上的布匹只有黑、白、灰、蓝四种颇色。	{'time': '1966', 'genre': 'literature', 'category': 'general fiction'}
因为焦淑红给他那本“饲养手册”上说，刷灰起消毒作用，可以消灭细菌；这细菌可怎么比划呢？	{'time': '1966', 'genre': 'literature', 'category': 'general fiction'}
“别急着问什么任务。	{'time': '1966', 'genre': 'literature', 'category': 'general fiction'}
从这一声呐喊开始，东山坞展开了轰轰烈烈的土地改革运动。	{'time': '1966', 'genre': 'literature', 'category': 'general fiction'}
“怎么早就收工了？”	{'time': '1966', 'genre': 'literature', 'category': 'general fiction'}
“淑红你快去吧，我让玉珍跟你做伴儿，省得一个人走黑路不方便。”	{'time': '1966', 'genre': 'literature', 'category': 'general fiction'}
福奶奶说：	{'time': '1966', 'genre': 'literature', 'category': 'general fiction'}
他忘记戴草帽子了，火热的太阳晒着他的头顶，汗水不住地往下滴。	{'time': '1966', 'genre': 'literature', 'category': 'general fiction'}
可以这样说；如果这会儿来一阵子瓢泼大雨，保险湿不着地皮。	{'time': '1966', 'genre': 'literature', 'category': 'general fiction'}
马连福说：	{'time': '1966', 'genre': 'literature', 'category': 'general fiction'}
成饱的麦穗儿，像是就要出嫁的闺女，含羞地低着头，又忍不住地发出微笑。	{'time': '1966', 'genre': 'literature', 'category': 'general fiction'}
“光大车运不过来了，暴雨就要到，全体出动往回背。”	{'time': '1966', 'genre': 'literature', 'category': 'general fiction'}
[假日的第二天，正赶上柳镇大集。	{'time': '1966', 'genre': 'literature', 'category': 'general fiction'}
这伙子社员在黑暗里互相望了一眼，也跟着韩百仲走。	{'time': '1966', 'genre': 'literature', 'category': 'general fiction'}
一夜失眠的马立本，今天早晨强打精神，把他应当做的事情全做完了，在办公室里静候贵客。	{'time': '1966', 'genre': 'literature', 'category': 'general fiction'}
男的，女的，老的，少的，穿着各种各样的衣裳，拿着各种各样的东西，掺和在一起，揉成了一个整块儿似的；你挤我，我挤你，推来拥去；身子瘦小灵巧的人沾了光，身体胖的，块头大，再笨重一点儿的，那可就倒霉了；不要说背着筐子、挑着担子的人，不能从这条正街上通过，就是光挎着一个篮子，也得举到头顶上去。	{'time': '1966', 'genre': 'literature', 'category': 'general fiction'}
“我说主任，社员是不是都得劳动？”	{'time': '1966', 'genre': 'literature', 'category': 'general fiction'}
我亲爱的红：	{'time': '1966', 'genre': 'literature', 'category': 'general fiction'}
一个是东山坞的党支部书记萧长春，一个是青年社员韩道满。	{'time': '1966', 'genre': 'literature', 'category': 'general fiction'}
可是，这丫头这几年跟他这个爸爸关系不太亲近，那中学离这儿只有三十里路，不要说星期日什么的不肯回家来探望探望双亲，连麦假、秋假也是在学校里住，不知道是学校里给她什么限制了，还是家里人得罪了她。	{'time': '1966', 'genre': 'literature', 'category': 'general fiction'}
“我长这么大都没干过这种活儿！”	{'time': '1966', 'genre': 'literature', 'category': 'general fiction'}
从打收割小麦起，好像从来没有过这么好的太阳，它也拿出自己全部的光和热，来烘晒满场黄金般的小麦。	{'time': '1966', 'genre': 'literature', 'category': 'general fiction'}
你有什么赃证把在人家手里，为什么在人家面前总是像小偷一样地提心吊胆呢？	{'time': '1966', 'genre': 'literature', 'category': 'general fiction'}
“好，不用说真勾搭上，真让咱们给抓住对儿，只要萧长春一动心，有了这番意思，名声传出去，马连福就得回来跟他砸脑袋，这杆枪就算让咱们攥住了，姓萧的在村里就得成了臭狗屎，再也不用想站住脚啦！	{'time': '1966', 'genre': 'literature', 'category': 'general fiction'}
马立本气的直跺脚。	{'time': '1966', 'genre': 'literature', 'category': 'general fiction'}
“喂，把门插上吧。”	{'time': '1966', 'genre': 'literature', 'category': 'general fiction'}
“我真不明白，您为什么总是打破坏星！”	{'time': '1966', 'genre': 'literature', 'category': 'general fiction'}
“老天爷保佑，但愿这一天快到门口儿，我真等急了，”又问：	{'time': '1966', 'genre': 'literature', 'category': 'general fiction'}
她想问，又不敢问，不问，又挺害怕。	{'time': '1966', 'genre': 'literature', 'category': 'general fiction'}
“咱们团支书要找婆家了！”	{'time': '1966', 'genre': 'literature', 'category': 'general fiction'}
她从场上跑出来，就奔大湾了，供销社、乡政府全都找了个遍；回来路过这儿，见好多人在河水里摸孩子，她都没有顾上脱下鞋袜，就跳在水里来了，湿衣服贴在身上，连头发梢都是水淋淋的。	{'time': '1966', 'genre': 'literature', 'category': 'general fiction'}
’” 大伙笑起来了。	{'time': '1966', 'genre': 'literature', 'category': 'general fiction'}
“哟，还用布置会场呀？”	{'time': '1966', 'genre': 'literature', 'category': 'general fiction'}
笑着跑到里边，猫着腰，仰着脸，转着圈儿看马老四。	{'time': '1966', 'genre': 'literature', 'category': 'general fiction'}
“咱们这个队数他调皮，有个机会还不整整他等什么呀！”	{'time': '1966', 'genre': 'literature', 'category': 'general fiction'}
东山坞是个正派的村子，劳动群众对男女之间的淫荡事儿，一向是嫉恶如仇的，她懂得了一点“羞耻”；再说，马连福对她体贴入微、百依百顺，又有了自己的骨肉，她也就有意地慢慢地收敛着那股子野性儿。	{'time': '1966', 'genre': 'literature', 'category': 'general fiction'}
“活人让尿憋死，总得点它。	{'time': '1966', 'genre': 'literature', 'category': 'general fiction'}
“我也得打头里一步一步地学。”	{'time': '1966', 'genre': 'literature', 'category': 'general fiction'}
他绕过几家后院墙，过来一看，果然是焦二菊。	{'time': '1966', 'genre': 'literature', 'category': 'general fiction'}
羊栏刷灰顶不顶用？	{'time': '1966', 'genre': 'literature', 'category': 'general fiction'}
这一来，萧长春可真像小孩子坐飞机抖起来了，真在这伙子老百姓里买下好了，反对他的人也就会越来越少。	{'time': '1966', 'genre': 'literature', 'category': 'general fiction'}
焦淑红对伙伴们说：	{'time': '1966', 'genre': 'literature', 'category': 'general fiction'}
焦淑红又着急地说：	{'time': '1966', 'genre': 'literature', 'category': 'general fiction'}
焦振茂按着闺女的意思，从场边上追回萧老大，一边拉扯着一边说：	{'time': '1966', 'genre': 'literature', 'category': 'general fiction'}
东山坞党支部决心要按着上级的指示精神，按着斗争形势的需要，着手纯洁组织。	{'time': '1966', 'genre': 'literature', 'category': 'general fiction'}
乡里的大个子武装部长骑车子跑过来了：	{'time': '1966', 'genre': 'literature', 'category': 'general fiction'}
你等着，我回家给你搬个皮褥子来。	{'time': '1966', 'genre': 'literature', 'category': 'general fiction'}
萧长春把神经衰弱的李世丹惊动了。	{'time': '1966', 'genre': 'literature', 'category': 'general fiction'}
挑担的，推车的，赶驴驮子和骑自行车的，还有步行的，男女老少全都有。	{'time': '1966', 'genre': 'literature', 'category': 'general fiction'}
焦克礼说：	{'time': '1966', 'genre': 'literature', 'category': 'general fiction'}
马之悦怕惹出事来，也就没有惊动她。	{'time': '1966', 'genre': 'literature', 'category': 'general fiction'}
最好是到野地里去遛，野地里空气新鲜，还可以让它啃一点嫩草吃……	{'time': '1966', 'genre': 'literature', 'category': 'general fiction'}
马小辫一跺脚：	{'time': '1966', 'genre': 'literature', 'category': 'general fiction'}
他站在门里，两只手叉着腰，愤愤地说：	{'time': '1966', 'genre': 'literature', 'category': 'general fiction'}
马立本说：	{'time': '1966', 'genre': 'literature', 'category': 'general fiction'}
他把主意打定，当着干部面上旁敲侧击，劝别人丢下手里的重要活儿找孩子，背着干部面就强“拉夫”，逼别人找孩子。	{'time': '1966', 'genre': 'literature', 'category': 'general fiction'}
在这些问题上，萧长春、韩百仲、喜老头都是自己的一面镜子呀！	{'time': '1966', 'genre': 'literature', 'category': 'general fiction'}
马之悦也就检讨开了，而且是从根上检讨的。	{'time': '1966', 'genre': 'literature', 'category': 'general fiction'}
马凤兰得意地拍了拍胖胸脯子说：	{'time': '1966', 'genre': 'literature', 'category': 'general fiction'}
“老王，老王，嘿嘿嘿，可找到你了！	{'time': '1966', 'genre': 'literature', 'category': 'general fiction'}
这回你放心，我保险今天这会出不了乱子。”	{'time': '1966', 'genre': 'literature', 'category': 'general fiction'}
走吧。”	{'time': '1966', 'genre': 'literature', 'category': 'general fiction'}
就是捂着半边嘴也够跟他们说的。	{'time': '1966', 'genre': 'literature', 'category': 'general fiction'}
孔老头根本没看清骑车子进来的这个人的脸，却从车灯、车铃和那熟练的车技、潇洒的动作认出是谁来了，忙迎过来打招呼：	{'time': '1966', 'genre': 'literature', 'category': 'general fiction'}
’把我气坏了。”	{'time': '1966', 'genre': 'literature', 'category': 'general fiction'}
正在给牲口挠毛的马老四，听了这句话，看了儿子一眼，那只枯瘦的大手不由得抖了一下。	{'time': '1966', 'genre': 'literature', 'category': 'general fiction'}
韩小乐说：	{'time': '1966', 'genre': 'literature', 'category': 'general fiction'}
小石头迎过来说：	{'time': '1966', 'genre': 'literature', 'category': 'general fiction'}
“树林子里边有蘑菇，咱们采蘑菇好吧？”	{'time': '1966', 'genre': 'literature', 'category': 'general fiction'}
“我可不去，他不害操，我见了他倒有点不好意思。	{'time': '1966', 'genre': 'literature', 'category': 'general fiction'}
他要抽空子在马连福身上作作工夫，给马连福打打气儿。	{'time': '1966', 'genre': 'literature', 'category': 'general fiction'}
刚才我把场上的木头拆回家，他们连个屁都没敢放，焦克礼要是敢找我的麻烦，我要不给他个好看才怪！	{'time': '1966', 'genre': 'literature', 'category': 'general fiction'}
“早？	{'time': '1966', 'genre': 'literature', 'category': 'general fiction'}
“来人怎么着？”	{'time': '1966', 'genre': 'literature', 'category': 'general fiction'}
他不赞成别人“往泥里踩”马之悦，但也怕马之悦出问题。	{'time': '1966', 'genre': 'literature', 'category': 'general fiction'}
昨天晚上的贫下中农代表会开得非常成功，总结了过去的工作，制定了今后的计划，通过了代理队长和撤换会计的事儿；刚才他又跟韩百仲碰了下头，把该决定的事儿决定下来，打算下午找三个团支委了解一下昨天下午团支部扩大会的情况，就要准备明天赶集的事儿了。	{'time': '1966', 'genre': 'literature', 'category': 'general fiction'}
东山坞农业社离开我马立本，那就等于抽了大梁，扳了大柱，“华啦”一下子就得垮！	{'time': '1966', 'genre': 'literature', 'category': 'general fiction'}
“现成的粥不吃，剩下馊了坏了，再另做别的，不浪费粮食呀！	{'time': '1966', 'genre': 'literature', 'category': 'general fiction'}
是改了户头，还是把钱扣在社里，还是队里给挪用了？	{'time': '1966', 'genre': 'literature', 'category': 'general fiction'}
节省一点儿，也就接上麦秋分麦子了。	{'time': '1966', 'genre': 'literature', 'category': 'general fiction'}
这封信落在焦淑红的手里，怎么能不使她动心呢？	{'time': '1966', 'genre': 'literature', 'category': 'general fiction'}
等到人们全都动起来了，他才又用“两掺”着的神态，来到了河边上“督阵”。	{'time': '1966', 'genre': 'literature', 'category': 'general fiction'}
该修轴的修轴，该换瓦（老式车轮没胶胎，钉着一圈很厚的铁板，称车瓦，或铁瓦）的换瓦，该上油的上油，不齐全的地方全都补齐了。	{'time': '1966', 'genre': 'literature', 'category': 'general fiction'}
“叫我干什么呀？”	{'time': '1966', 'genre': 'literature', 'category': 'general fiction'}
这是什么意思呢？	{'time': '1966', 'genre': 'literature', 'category': 'general fiction'}
他的身上、手上，全是火烧火燎的一般，往外冒着热汗，又跟雨水混在一起，发出一股子臭味儿……	{'time': '1966', 'genre': 'literature', 'category': 'general fiction'}
“这回喜老头可要享晚福了。”	{'time': '1966', 'genre': 'literature', 'category': 'general fiction'}
淑红那丫头，总想往高枝上飞，一听嫁个比她高的知识分子，不乐疯了！”	{'time': '1966', 'genre': 'literature', 'category': 'general fiction'}
“我就走！	{'time': '1966', 'genre': 'literature', 'category': 'general fiction'}
这是麦收前的最后一个集日了，家家户户都有点事儿要办，就是没啥大事儿的人，也想着到集上转转，看看热闹。	{'time': '1966', 'genre': 'literature', 'category': 'general fiction'}
萧长春笑着说：	{'time': '1966', 'genre': 'literature', 'category': 'general fiction'}
斧子凿子在这儿乒乒乓乓地响。	{'time': '1966', 'genre': 'literature', 'category': 'general fiction'}
“不费事，不费事。”	{'time': '1966', 'genre': 'literature', 'category': 'general fiction'}
六旬开外的一个老年人，经住了这样一场沉重的打击，不要说外人，恐怕连他自己过去都是不敢想的。	{'time': '1966', 'genre': 'literature', 'category': 'general fiction'}
他见几个后到的代表找地方坐下了，就说：	{'time': '1966', 'genre': 'literature', 'category': 'general fiction'}
为这件事儿，萧长春几次要求老饲养员。	{'time': '1966', 'genre': 'literature', 'category': 'general fiction'}
“我走呀……”	{'time': '1966', 'genre': 'literature', 'category': 'general fiction'}
想到这儿，他又觉着这个萧长春真可恶；自己的作风不正派，把东山坞搞成一团糟，一点自觉没有，还要找靠山，给别人走黑信；而且，刚刚当半年支部书记，眼睛就长到脑门子上去了，出来进去地找王国忠，自己这个乡长，他都没有用眼夹一夹，难怪马之悦说他骄傲自满，目空一切，真是不假！	{'time': '1966', 'genre': 'literature', 'category': 'general fiction'}
我怕他长不大，就……”	{'time': '1966', 'genre': 'literature', 'category': 'general fiction'}
他又埋怨自己：	{'time': '1966', 'genre': 'literature', 'category': 'general fiction'}
“人家才是真正的党员哪！”	{'time': '1966', 'genre': 'literature', 'category': 'general fiction'}
“不是亲眼看见，谁说我也不能信。”	{'time': '1966', 'genre': 'literature', 'category': 'general fiction'}
“喂，你是哪儿的，怎么啦？”	{'time': '1966', 'genre': 'literature', 'category': 'general fiction'}
“这才好。	{'time': '1966', 'genre': 'literature', 'category': 'general fiction'}
他从后院跑到街上，本想去找萧长春，可是，不敢惹事儿的伯伯韩百旺，不知不觉地影响着这个小伙子，影响得他粗野中多少带一点儿世故。	{'time': '1966', 'genre': 'literature', 'category': 'general fiction'}
公路是宽宽的，靠南边有一溜棚子和土屋，一家修自行车的，一家钉牲口掌的，一家卖烟酒的，末了那家是个小茶棚子。	{'time': '1966', 'genre': 'literature', 'category': 'general fiction'}
日头挺毒，汗流的多，口渴的难受，跑家去喝，或是跑到官井沿去喝，全都耽误时间，取个近便，在马小辫这儿喝一口算了。	{'time': '1966', 'genre': 'literature', 'category': 'general fiction'}
“喂，我问你一个字儿。”	{'time': '1966', 'genre': 'literature', 'category': 'general fiction'}
[休息过后，地主马小辫又跟别人膀顶膀地干了一阵儿，就再也支持不住了。	{'time': '1966', 'genre': 'literature', 'category': 'general fiction'}
“别往里挤了，这儿坐吧。”	{'time': '1966', 'genre': 'literature', 'category': 'general fiction'}
你找我，还是我爸爸呀？”	{'time': '1966', 'genre': 'literature', 'category': 'general fiction'}
淑红妈和克礼妈一边一个搀扶着萧老大站在河边上，看着水里的人摸索，同时不住声地解劝着、安慰着萧老大，说尽了开心的话儿。	{'time': '1966', 'genre': 'literature', 'category': 'general fiction'}
“我看他这个乡长是当够了！”	{'time': '1966', 'genre': 'literature', 'category': 'general fiction'}
“怎么，收场了？”	{'time': '1966', 'genre': 'literature', 'category': 'general fiction'}
噢，准是李世丹乡长回来了，昨晚上找过萧长春，给自己说了好话，或许批评了他们，再不，就是上边又有了什么新的指示，很可能跟马志新信上所说的内容有关，上边发现他们的房顶不牢靠了，想要抓底下的基石，要在农村和下边安定人心，特别要安定那些根子比较硬的村干部，而马之悦被他们划在这一栏里了，他们要转弯儿，要笼络自己，要……	{'time': '1966', 'genre': 'literature', 'category': 'general fiction'}
小石头扑过来，抱住了他的腿：	{'time': '1966', 'genre': 'literature', 'category': 'general fiction'}
县委马上要派工作组去，这之前，对一切问题不要擅自处理。”	{'time': '1966', 'genre': 'literature', 'category': 'general fiction'}
那团团的榆树钱，那串串的酸枣子，曾经填满他多少次饥饿的肚皮？	{'time': '1966', 'genre': 'literature', 'category': 'general fiction'}
年轻人呢，听出马之悦是话里套话地骂人，更气的不得了，全都不听他的，吵得更凶了。	{'time': '1966', 'genre': 'literature', 'category': 'general fiction'}
相信的事儿，预料到的事儿，成了事实，摆在他的眼前的时候，他还是被震惊了。	{'time': '1966', 'genre': 'literature', 'category': 'general fiction'}
焦二菊把手里的东西往大腿底下一压，挺神秘地说：	{'time': '1966', 'genre': 'literature', 'category': 'general fiction'}
弯弯绕是刚刚被队长给喊来的，一时不知道干什么，想到场房里找一件顺手的家什。	{'time': '1966', 'genre': 'literature', 'category': 'general fiction'}
萧老大说：	{'time': '1966', 'genre': 'literature', 'category': 'general fiction'}
您看看人家焦克礼，人家韩小乐，人家一个个入了团，这会儿，一个当了队长，一个又要当会计！	{'time': '1966', 'genre': 'literature', 'category': 'general fiction'}
嘿。	{'time': '1966', 'genre': 'literature', 'category': 'general fiction'}
有一回弯弯绕端着盆子往饲养场那边走，我问他干什么去，他说：	{'time': '1966', 'genre': 'literature', 'category': 'general fiction'}
坏事情的盖子还没有彻底揭开，麦子还没有收上来。	{'time': '1966', 'genre': 'literature', 'category': 'general fiction'}
她正要关前院大门，从外边闪进来一个人。	{'time': '1966', 'genre': 'literature', 'category': 'general fiction'}
只是北坎子上聚着仨一群俩一伙的人，没边没沿地议论著，那气氛显得格外紧张。	{'time': '1966', 'genre': 'literature', 'category': 'general fiction'}
你到街上看看，大伙的心气全变了，谁也不喊没吃的了。	{'time': '1966', 'genre': 'literature', 'category': 'general fiction'}
他还像过去那样光说光溜话，不办光溜事儿呀？”	{'time': '1966', 'genre': 'literature', 'category': 'general fiction'}
两只眼睛盯着大道，总不见他约好的那些人到来，心里也很有点着急。	{'time': '1966', 'genre': 'literature', 'category': 'general fiction'}
从打一开场，他心上就系了一个大疙瘩：	{'time': '1966', 'genre': 'literature', 'category': 'general fiction'}
“萧支书，可，可不好啦，可不好啦！”	{'time': '1966', 'genre': 'literature', 'category': 'general fiction'}
每堆都有每堆有意思的话题，有抬杠，有呼喊，有放声大笑。	{'time': '1966', 'genre': 'literature', 'category': 'general fiction'}
他走得很急，急着要把从王来泉那儿听到的东西告诉给他的同志们；他把两只手合成一个圈儿，套在嘴上，大声地喊：	{'time': '1966', 'genre': 'literature', 'category': 'general fiction'}
还有，村子里都有哪些户参加了，是经常的，还是偶尔这一次？	{'time': '1966', 'genre': 'literature', 'category': 'general fiction'}
明天赶集，跟萧长春一道去，把事情说一定，回来再跟爸爸妈妈一说，就算没问题了，往后再不会有这种事情纠缠了！	{'time': '1966', 'genre': 'literature', 'category': 'general fiction'}
“表姨夫，昨天晌午开的什么会呀？	{'time': '1966', 'genre': 'literature', 'category': 'general fiction'}
“怎么样小干，又怎么样大干呢？”	{'time': '1966', 'genre': 'literature', 'category': 'general fiction'}
他说：	{'time': '1966', 'genre': 'literature', 'category': 'general fiction'}
马立本骂了马子怀一句，又跑进了马大炮家的院子里。	{'time': '1966', 'genre': 'literature', 'category': 'general fiction'}
马长山跑出老远，回头说：	{'time': '1966', 'genre': 'literature', 'category': 'general fiction'}
“志德，你这两天一直在场上干活儿吗？”	{'time': '1966', 'genre': 'literature', 'category': 'general fiction'}
“我跟你们说不上，我找你们队长去，看他敢把我圆了，还是敢把我扁了！”	{'time': '1966', 'genre': 'literature', 'category': 'general fiction'}
“噢，你还为这个发愁哇！	{'time': '1966', 'genre': 'literature', 'category': 'general fiction'}
看电话的小张，一个十八、九岁的高小毕业的学生，应声跑了过来，一撩门帘子，就满脸喜气地说：	{'time': '1966', 'genre': 'literature', 'category': 'general fiction'}
还有，谁不知道咱两家是亲戚，出了这种事儿，还有不找地主的呀？	{'time': '1966', 'genre': 'literature', 'category': 'general fiction'}
小臣一拨楞脑袋：	{'time': '1966', 'genre': 'literature', 'category': 'general fiction'}
再说，全国一个令，弯弯绕就是想卖，到哪儿卖去呀？	{'time': '1966', 'genre': 'literature', 'category': 'general fiction'}
他又把面前的两个人瞄了一遍，萧长春的态度是严肃的、热烈的，韩百仲脸上的表情是安静的、郑重的……	{'time': '1966', 'genre': 'literature', 'category': 'general fiction'}
他的脑袋里呼隆呼隆地像是转着一盘石磨。	{'time': '1966', 'genre': 'literature', 'category': 'general fiction'}
唉，我真不知道应该怎么帮帮他，表表我的心意。”	{'time': '1966', 'genre': 'literature', 'category': 'general fiction'}
他简单地跟他们打过招呼，谢绝喝酒吃饭的邀请，不停步地朝里挤。	{'time': '1966', 'genre': 'literature', 'category': 'general fiction'}
找新上任的队长焦克礼吗？	{'time': '1966', 'genre': 'literature', 'category': 'general fiction'}
韩百仲又问：	{'time': '1966', 'genre': 'literature', 'category': 'general fiction'}
人强马壮，马壮人强，这是过农业社大日子缺一不可的。	{'time': '1966', 'genre': 'literature', 'category': 'general fiction'}
韩德大说：	{'time': '1966', 'genre': 'literature', 'category': 'general fiction'}
“得设法找他们出来呀。”	{'time': '1966', 'genre': 'literature', 'category': 'general fiction'}
“哼，我跟你们也不是一家子！	{'time': '1966', 'genre': 'literature', 'category': 'general fiction'}
他把工作手续全部都交给了焦克礼；行李也打上了，干粮也包上了，连出门穿的衣服也换上了；这会儿，他到饲养场，跟他爸爸马老四告别来了。	{'time': '1966', 'genre': 'literature', 'category': 'general fiction'}
这是他的革命思想启蒙课本，也是他这半辈，除了黄历接触到的第一本书，那是党员焦田，在北山坡子打柴禾的时候，亲手交给他的；从那以后，每天晚上，几个长工，几个贫农和几个村干部就凑到他这间小土屋里，点的也是这盏小小的省油灯；他们围在灯光下边，焦田给他们念，他们一句一句地听，一字一字地记，一点一滴地吸收和消化，又一条一条地用自己的行动去实现书本上边的要求。	{'time': '1966', 'genre': 'literature', 'category': 'general fiction'}
为了能够完成这件自己给自己的任务，他狠着心把焦克礼一个人扔在家里开那个社员会……	{'time': '1966', 'genre': 'literature', 'category': 'general fiction'}
冲他这股子大公无私的精神，我就是养你白头到老，也心甘情愿。	{'time': '1966', 'genre': 'literature', 'category': 'general fiction'}
咱们先开个干部和社员代表会，让他检讨，他要低了头，就罢了，这是小干；要不低头，再开社员大会，让大伙儿评理，这就是大干。”	{'time': '1966', 'genre': 'literature', 'category': 'general fiction'}
五婶说：	{'time': '1966', 'genre': 'literature', 'category': 'general fiction'}
马之悦听完，就拍着大腿说：	{'time': '1966', 'genre': 'literature', 'category': 'general fiction'}
他们每个人都像刚从水里捞出来。	{'time': '1966', 'genre': 'literature', 'category': 'general fiction'}
因为他们把农业社的生产跟他们生活、命运连在一块儿了；农业社的生产搞得好，他们生活就有了保障，就会过得幸福，所以他们都随时随地的想着农业社的生产。	{'time': '1966', 'genre': 'literature', 'category': 'general fiction'}
焦淑红的两只眼睛紧紧地盯着马之悦，一直没说话，心里边猜想他会说出什么来，干出什么来，自己又应当怎么对待，听他点名了，也一步登上石桥，挺着胸脯子说：	{'time': '1966', 'genre': 'literature', 'category': 'general fiction'}
小石桥那儿汇集了一大群人，奔麦地里去了；又汇集了一大群人，也奔麦地里去了……	{'time': '1966', 'genre': 'literature', 'category': 'general fiction'}
你到底儿都发给谁了？”	{'time': '1966', 'genre': 'literature', 'category': 'general fiction'}
马志德低声说：	{'time': '1966', 'genre': 'literature', 'category': 'general fiction'}
屋里只剩下两个支部书记。	{'time': '1966', 'genre': 'literature', 'category': 'general fiction'}
“哼哼，不嘛，不嘛，偏要吃饼子，偏要吃饼子！”	{'time': '1966', 'genre': 'literature', 'category': 'general fiction'}
他一听立刻就急了，开腿就往外跑，想把马小辫追回来。	{'time': '1966', 'genre': 'literature', 'category': 'general fiction'}
我说支书，我可有好多问题，你若让我先提，你也得马上回答我！”	{'time': '1966', 'genre': 'literature', 'category': 'general fiction'}
“干部家的人更不能例外吧？”	{'time': '1966', 'genre': 'literature', 'category': 'general fiction'}
他没有经过事儿，遇到事儿就慌了。	{'time': '1966', 'genre': 'literature', 'category': 'general fiction'}
“还看我妹妹哪，连我自己这出戏还不知道怎么唱哪！”	{'time': '1966', 'genre': 'literature', 'category': 'general fiction'}
“什么，三天就学会打算盘呀？”	{'time': '1966', 'genre': 'literature', 'category': 'general fiction'}
他一只手拿着烟斗，一只手抓着话筒，眼神直着，耳朵伸着，捕捉着话筒里传过来的每一个字儿；他离开了东山坞，可是还惦着东山坞，他想知道这儿的一切，越详细越好。	{'time': '1966', 'genre': 'literature', 'category': 'general fiction'}
据说挖河的工程进展挺快，东山坞的民工单独包下最艰难的一段，替出别的民工队，很快就要往东南伸展；等到麦子一入仓，东西两路大队就要会师了，河道就合拢了，秋后再把渠道修起来，冬小麦就能够自流灌溉。	{'time': '1966', 'genre': 'literature', 'category': 'general fiction'}
这个胖女人也是心怀诡计，不办成了不甘心，她把办法都想尽想绝了，像一个打猎的人，两只贼眼溜溜转，专找目标下家伙；这几天，随时随地都能在坎子上看到她的影子，表面上挺悠闲，心里边却又是锣又是鼓。	{'time': '1966', 'genre': 'literature', 'category': 'general fiction'}
他知道，目前东山坞的那股子黑水虽然还在流，可是，党支部已经找到了它的来源，也看出了它的去向；党支部一方面作了许多艰苦工作，把贫下中农调动起来了，把许多中农团结起来了；这个队伍如今正在扩展，人们的心界也正在一步一步地提高……	{'time': '1966', 'genre': 'literature', 'category': 'general fiction'}
为把东山坞建设成社会主义铁打江山，让这儿的人，世世代代再也受不着咱们过去受的那份苦，让这儿的人，享受到过去世世代代的人都没有享受过的福。	{'time': '1966', 'genre': 'literature', 'category': 'general fiction'}
会场设在大庙的北大殿里，两个保险灯分别吊在两架大柁上，特别明亮。	{'time': '1966', 'genre': 'literature', 'category': 'general fiction'}
马之悦说：	{'time': '1966', 'genre': 'literature', 'category': 'general fiction'}
让我把他数叨一顿。”	{'time': '1966', 'genre': 'literature', 'category': 'general fiction'}
不是说等过了麦收才能工作吗？	{'time': '1966', 'genre': 'literature', 'category': 'general fiction'}
不单是为这个！”	{'time': '1966', 'genre': 'literature', 'category': 'general fiction'}
“共产党领着咱们翻了身，是让咱们享福的，不是让咱们活着受罪的！”	{'time': '1966', 'genre': 'literature', 'category': 'general fiction'}
我们也得像支部那样讲究民主集中制。	{'time': '1966', 'genre': 'literature', 'category': 'general fiction'}
“人家知道那是啥意思呀！”	{'time': '1966', 'genre': 'literature', 'category': 'general fiction'}
马小辫一愣：	{'time': '1966', 'genre': 'literature', 'category': 'general fiction'}
这一天，老头子做好了午饭，打发孙子小石头先吃，自己坐在前门坎子上，一边抽烟，一边等儿子。	{'time': '1966', 'genre': 'literature', 'category': 'general fiction'}
“笑话按斤卖还是两称？	{'time': '1966', 'genre': 'literature', 'category': 'general fiction'}
“同利办事儿是有点不像话，照他那样，谁也不用想过口子了。”	{'time': '1966', 'genre': 'literature', 'category': 'general fiction'}
他越过沟，又爬上北坎。	{'time': '1966', 'genre': 'literature', 'category': 'general fiction'}
萧长春朝这边走着，两只眼睛紧紧地盯着弯弯绕。	{'time': '1966', 'genre': 'literature', 'category': 'general fiction'}
“炕上坐吧。”	{'time': '1966', 'genre': 'literature', 'category': 'general fiction'}
没有个安定日子！”	{'time': '1966', 'genre': 'literature', 'category': 'general fiction'}
农活忙起来之后，很少见到有人打扑克和下老虎棋，这会儿也在街头巷尾、门道里和树荫下活跃起来了。	{'time': '1966', 'genre': 'literature', 'category': 'general fiction'}
他结合前天晚上王国忠跟他谈的话，给他看的文件，进一步认识到农村两条道路斗争的复杂性；不论对待什么事情，都不能简单地拿个现成的套子去套，更不能把它想得那么轻易。	{'time': '1966', 'genre': 'literature', 'category': 'general fiction'}
昨个，队长明明在会上宣布了让大伙儿把鸡都圈起来，大伙儿全都点头赞成了，他今天偏偏把鸡放出来；捉住手腕子了，还胡搅蛮缠……”	{'time': '1966', 'genre': 'literature', 'category': 'general fiction'}
接着，又在韩百安那花白的头顶上看了一眼。	{'time': '1966', 'genre': 'literature', 'category': 'general fiction'}
他奇怪了吗？	{'time': '1966', 'genre': 'literature', 'category': 'general fiction'}
当年，他一进东山坞，就听到好多老百姓谈论马之悦的功劳，说马之悦用脑袋保护了他们。	{'time': '1966', 'genre': 'literature', 'category': 'general fiction'}
十五年前，马之悦光着身子进了“政界”，那时候，手心朝地，又手心朝天，上下一翻，左右一耍，江山就打出来了。	{'time': '1966', 'genre': 'literature', 'category': 'general fiction'}
他又挤进了百货公司。	{'time': '1966', 'genre': 'literature', 'category': 'general fiction'}
来到地里，闲话不说，动手就干。	{'time': '1966', 'genre': 'literature', 'category': 'general fiction'}
“光您着急不行，人家支书心里边没有装着这个。”	{'time': '1966', 'genre': 'literature', 'category': 'general fiction'}
兄弟死了，韩百旺把韩德大当自己的骨肉看待。	{'time': '1966', 'genre': 'literature', 'category': 'general fiction'}
土改那年，树木分给了十几家没房子住的贫农户。	{'time': '1966', 'genre': 'literature', 'category': 'general fiction'}
马之悦安慰了他；他自己呢，也连着花了两个晚上时间，又重新修补了一下漏口裂缝儿；马立本对账本有一种一手翻天一手覆地的本领，只要他这么一修一堵，就能面面光滑，任凭你怎么追究，也不用想看出什么破绽来。	{'time': '1966', 'genre': 'literature', 'category': 'general fiction'}
在人多的场面，他从来不爱说话儿，也不爱表功劳。	{'time': '1966', 'genre': 'literature', 'category': 'general fiction'}
“唉，都怪我没有估到这一步。	{'time': '1966', 'genre': 'literature', 'category': 'general fiction'}
马小辫也动了动，抹抹汗珠子。	{'time': '1966', 'genre': 'literature', 'category': 'general fiction'}
弯弯绕这伙子中农铁了心要发家当财主；李世丹这个老上级，不光对马之悦百分之百的信赖，两个人在好多地方是“情投意合”的；只要圈拢住弯弯绕，再拉上李世丹，上下有靠，变祸为福，那就十拿九稳了。	{'time': '1966', 'genre': 'literature', 'category': 'general fiction'}
能挺到这会儿真不易呀！”	{'time': '1966', 'genre': 'literature', 'category': 'general fiction'}
人家派我去，我要坐坡，那多不好！”	{'time': '1966', 'genre': 'literature', 'category': 'general fiction'}
一大群穿得破衣拉花的男男女女挤在大庙里开了个动员会；随后由支书焦田、贫农团主席韩百仲和农会主任马同峰几个人率领，喊着口号，打着锣鼓，来到这个狮子院。	{'time': '1966', 'genre': 'literature', 'category': 'general fiction'}
他看到篮子里边有两个大烙合子，还有两本子旧书。	{'time': '1966', 'genre': 'literature', 'category': 'general fiction'}
“筷子挟骨头，三条光棍儿。	{'time': '1966', 'genre': 'literature', 'category': 'general fiction'}
东山坞的积极分子们，一边等着萧长春来传达上级党组织的指示和决定，一边按著「一手抓斗争，一手抓生产”的精神，按部就班地忙着自己的工作。	{'time': '1966', 'genre': 'literature', 'category': 'general fiction'}
到小河里挑方便。”	{'time': '1966', 'genre': 'literature', 'category': 'general fiction'}
拴柱说：	{'time': '1966', 'genre': 'literature', 'category': 'general fiction'}
那边的屋子里从门口滚出热气。	{'time': '1966', 'genre': 'literature', 'category': 'general fiction'}
“当然记得。	{'time': '1966', 'genre': 'literature', 'category': 'general fiction'}
“怎么办呢，我看哪，从今以后，咱们要学会打主动仗。”	{'time': '1966', 'genre': 'literature', 'category': 'general fiction'}
马立本的假日是最舒服的──躺在炕上睡大觉，睡够了吃，吃完了，还是躺着，看他的“三侠剑”、“啼笑姻缘”；养精蓄锐，单等马志新来了，他好“时来运转”。	{'time': '1966', 'genre': 'literature', 'category': 'general fiction'}
他想把接过来的账目早一点儿清理出来，早一点儿找出里边的问题，以便重新开始自己的工作。	{'time': '1966', 'genre': 'literature', 'category': 'general fiction'}
马凤兰说：	{'time': '1966', 'genre': 'literature', 'category': 'general fiction'}
马立本比比划划地说：	{'time': '1966', 'genre': 'literature', 'category': 'general fiction'}
因为他一天到晚没有事儿，总是鼓捣那几本子账和那把算盘，工作起来，业务水平的确很高，账本子干干净净，字儿写得漂漂亮亮，算盘打的又快又准；处理起眼跟前那些会计事务，应付一些社员的“官差”，也非常熟练。	{'time': '1966', 'genre': 'literature', 'category': 'general fiction'}
“啊，没撒呀？”	{'time': '1966', 'genre': 'literature', 'category': 'general fiction'}
正是干活的时候，弯弯绕跑到自己家门口蹲着，不用问，准是又来胡闹了。	{'time': '1966', 'genre': 'literature', 'category': 'general fiction'}
“他们舒坦坦地睡大觉，可把我老头子吓坏了。”	{'time': '1966', 'genre': 'literature', 'category': 'general fiction'}
“真坏呀！”	{'time': '1966', 'genre': 'literature', 'category': 'general fiction'}
“啪”地把耳机子一摔，“彭”地一声把门踢开，闯到院子，两只手插在裤子兜里，冲着北墙壁大发雷霆：	{'time': '1966', 'genre': 'literature', 'category': 'general fiction'}
吃过饭你们别全颠了，咱们要开个碰头会，地点在沟里，你们爷俩去一个。	{'time': '1966', 'genre': 'literature', 'category': 'general fiction'}
怎么才能把收麦子、分麦子的这条腿拖住呢？	{'time': '1966', 'genre': 'literature', 'category': 'general fiction'}
弯弯绕像一只气蛤蟆似的，嘟嘟噢嚷地往村里走。	{'time': '1966', 'genre': 'literature', 'category': 'general fiction'}
韩德大站在道沟里，左等右等不见焦振丛回来，急得他火顶脑瓜门子，就先一步来到大庙里；到这儿以后，没说上几句话，就跟大伯吵起来了。	{'time': '1966', 'genre': 'literature', 'category': 'general fiction'}
你看他，过去到会场开会都得用人扶着才能走，这会儿，既不坐车，也不骑驴，遥遥二十里的柳镇，竟被他一步一步地走到了！	{'time': '1966', 'genre': 'literature', 'category': 'general fiction'}
这该怎么办呢？	{'time': '1966', 'genre': 'literature', 'category': 'general fiction'}
一伸手把萧长春手里的黄瓜夺过来了，“从哪儿偷来的？”	{'time': '1966', 'genre': 'literature', 'category': 'general fiction'}
“又耍孩子气了！”	{'time': '1966', 'genre': 'literature', 'category': 'general fiction'}
瞧瞧，马家的富贵、威风，真正成了一扫光！	{'time': '1966', 'genre': 'literature', 'category': 'general fiction'}
有几个妇女在那儿劝说，大概劝了好久，也有人劝得不耐烦，就撇下她走了。	{'time': '1966', 'genre': 'literature', 'category': 'general fiction'}
我过去干了二十天就下来了，再接过来，能行吗？”	{'time': '1966', 'genre': 'literature', 'category': 'general fiction'}
一个农业社的办公室，社员们常来常往，对每个人都是熟悉的，到了这儿，都不会有什么特别的感觉；可是，对韩小乐来说，心情却是非常复杂，差不多每一次来到这儿，心里边都要不知不觉地动一动，这一次当然动得更要厉害一点儿了。	{'time': '1966', 'genre': 'literature', 'category': 'general fiction'}
“人家小乐当会计了，连行李都搬到办公室，还管挑水！”	{'time': '1966', 'genre': 'literature', 'category': 'general fiction'}
“你干脆就到我这儿住得了，咱俩好说个话儿，做个伴儿，免得自己孤孤单单的。	{'time': '1966', 'genre': 'literature', 'category': 'general fiction'}
萧长春这才开口说：	{'time': '1966', 'genre': 'literature', 'category': 'general fiction'}
通过这样一个会议，能给新队长正式地扬扬威风、长长勇气、立立威信。	{'time': '1966', 'genre': 'literature', 'category': 'general fiction'}
门口那边一伙子人正在交谈哪个人还没有来到会场，又怎么去动员。	{'time': '1966', 'genre': 'literature', 'category': 'general fiction'}
爸爸说过，哪天不干活儿，就给他捉鸟玩；今天地里进不去人，一定能上山了。	{'time': '1966', 'genre': 'literature', 'category': 'general fiction'}
不快出窝儿，一会儿我再来揪你！”	{'time': '1966', 'genre': 'literature', 'category': 'general fiction'}
不管什么样，都应当照着党的指示做，先把自己的队伍组织好，让大伙儿做好思想准备，不出事儿更好，出了事就要拼了性命顶住。	{'time': '1966', 'genre': 'literature', 'category': 'general fiction'}
马凤兰翻了翻白眼，从外间堂屋墙上的灯窑里端过一盏老式的“省油灯”，把它点着，又把那罩子灯吹灭。	{'time': '1966', 'genre': 'literature', 'category': 'general fiction'}
他想到这儿，一步跨上石桥，摆出一副领导者的姿态，冲着年轻人说：	{'time': '1966', 'genre': 'literature', 'category': 'general fiction'}
不翻也得翻，不斗也得斗，要不然，往后什么工作也推动不了啦。	{'time': '1966', 'genre': 'literature', 'category': 'general fiction'}
“我烧着这把火还有事儿哪。”	{'time': '1966', 'genre': 'literature', 'category': 'general fiction'}
瓦刀脸女人说：	{'time': '1966', 'genre': 'literature', 'category': 'general fiction'}
没地方搭床，他就在地上铺些干草，睡在牲口槽底下。	{'time': '1966', 'genre': 'literature', 'category': 'general fiction'}
“还有别的问题，我们一家大小得吃饭，得活下去呀！”	{'time': '1966', 'genre': 'literature', 'category': 'general fiction'}
心想，我正要找你，你就来了，好哇，咱们就绕绕看吧。	{'time': '1966', 'genre': 'literature', 'category': 'general fiction'}
“他到哪儿去也没跟你说一声吗？”	{'time': '1966', 'genre': 'literature', 'category': 'general fiction'}
“我要上工地呀。”	{'time': '1966', 'genre': 'literature', 'category': 'general fiction'}
把门虎怒气不消地说：	{'time': '1966', 'genre': 'literature', 'category': 'general fiction'}
焦淑红压低嗓门儿说：	{'time': '1966', 'genre': 'literature', 'category': 'general fiction'}
这边正在起第二场麦子。	{'time': '1966', 'genre': 'literature', 'category': 'general fiction'}
“歇歇班，人是铁，饭是钢，肚子空着不当家，干一会就顶不住了。”	{'time': '1966', 'genre': 'literature', 'category': 'general fiction'}
“我给你壮胆呀！	{'time': '1966', 'genre': 'literature', 'category': 'general fiction'}
孙桂英正要点火，瞥了丈夫一眼，没说话。	{'time': '1966', 'genre': 'literature', 'category': 'general fiction'}
搁在往日，焦克礼早就招呼上几个伴儿，说说笑笑、打打闹闹地到街上逛逛了，眼下他可没有这份闲心。	{'time': '1966', 'genre': 'literature', 'category': 'general fiction'}
马之悦要是从根上、梢上烂了，他都得负责任，这个责任还不小。	{'time': '1966', 'genre': 'literature', 'category': 'general fiction'}
因此，他们决定对马连福和弯弯绕的问题只作一般揭发，不去公开追查，全都记在账上，看他们以后的具体表现，再做处理。	{'time': '1966', 'genre': 'literature', 'category': 'general fiction'}
这会儿，有一个人，正在着急地等着萧长春。	{'time': '1966', 'genre': 'literature', 'category': 'general fiction'}
姑娘心里发懵：	{'time': '1966', 'genre': 'literature', 'category': 'general fiction'}
“谁也没料到好好的日子，猛古丁地来了这么一档子事。”	{'time': '1966', 'genre': 'literature', 'category': 'general fiction'}
“妈……”	{'time': '1966', 'genre': 'literature', 'category': 'general fiction'}
这一阵子的马连福，比任何时候都平静，又比任何时候都不平静，他是故作平静，追求平静，可又平静不下来。	{'time': '1966', 'genre': 'literature', 'category': 'general fiction'}
他在炕上挪着，挪到窗前，耳朵贴着窗户纸儿听听。	{'time': '1966', 'genre': 'literature', 'category': 'general fiction'}
就是对弯弯绕、马子怀这些人，也不能不起一点儿“打骡子马也惊”的影响吧？	{'time': '1966', 'genre': 'literature', 'category': 'general fiction'}
“今天的党支部会就开到这里，让老马回去再好好想一想，改日再开。	{'time': '1966', 'genre': 'literature', 'category': 'general fiction'}
他喊着：	{'time': '1966', 'genre': 'literature', 'category': 'general fiction'}
那些逼着她啼哭的人，那些看着她啼哭的人，早就像没有这档子事儿一样，都一心一意地干自己的事情去了。	{'time': '1966', 'genre': 'literature', 'category': 'general fiction'}
几盘铡刀，一齐动起来了；又一场麦穗子摊开了，骡呀，马呀，又套上了……	{'time': '1966', 'genre': 'literature', 'category': 'general fiction'}
“要做，我还不会，总得等着你呀！	{'time': '1966', 'genre': 'literature', 'category': 'general fiction'}
结婚两三年，好像头一次自己顶门立户，真有些四面不着地的感觉。	{'time': '1966', 'genre': 'literature', 'category': 'general fiction'}
“什么你的，我的，别废话，快给孩子冲点喝吧！”	{'time': '1966', 'genre': 'literature', 'category': 'general fiction'}
老人家把这番意思说完了，这才心满意足地走了。	{'time': '1966', 'genre': 'literature', 'category': 'general fiction'}
小石头指点着蛤蟆说：	{'time': '1966', 'genre': 'literature', 'category': 'general fiction'}
“去你的吧。”	{'time': '1966', 'genre': 'literature', 'category': 'general fiction'}
这里边还有一个女的，那是焦淑红。	{'time': '1966', 'genre': 'literature', 'category': 'general fiction'}
王国忠忍不住嘿嘿地笑了：	{'time': '1966', 'genre': 'literature', 'category': 'general fiction'}
焦淑红一边揭开篮子上的毛巾，一边说：	{'time': '1966', 'genre': 'literature', 'category': 'general fiction'}
“商量好了，她愿意让我去。”	{'time': '1966', 'genre': 'literature', 'category': 'general fiction'}
马之悦把一切都安排好了之后，就到马连福家来了。	{'time': '1966', 'genre': 'literature', 'category': 'general fiction'}
慢说他没有把人逼到那份儿上，就是逼我没路走了，我也不干，我还想多活几天哪！”	{'time': '1966', 'genre': 'literature', 'category': 'general fiction'}
韩百仲说：	{'time': '1966', 'genre': 'literature', 'category': 'general fiction'}
王国忠会心地笑笑：	{'time': '1966', 'genre': 'literature', 'category': 'general fiction'}
“当然看见啦！	{'time': '1966', 'genre': 'literature', 'category': 'general fiction'}
可是，韩百旺心里边可难受极啦！	{'time': '1966', 'genre': 'literature', 'category': 'general fiction'}
他深深地透了口气，又把脑袋缩进来，回到里间屋，略微楞了片刻，摸到墙角，先搬过一个盛着破烂的筐子，又撬起一块石板，这儿是水沟眼子。	{'time': '1966', 'genre': 'literature', 'category': 'general fiction'}
韩百安说：	{'time': '1966', 'genre': 'literature', 'category': 'general fiction'}
李世丹走进他那离别好多日子的屋里，把灯亮捻大一点儿，到处看看。	{'time': '1966', 'genre': 'literature', 'category': 'general fiction'}
韩道满被他闹的挺奇怪，忙问：	{'time': '1966', 'genre': 'literature', 'category': 'general fiction'}
我让福奶奶找咱们马主任的太太去了；总让她坐在凉快地方等着吃现成的还行呀！	{'time': '1966', 'genre': 'literature', 'category': 'general fiction'}
她头发乱着，衣裳襟儿敞着，眼角上带着眵目糊，一边朝里走，一边在脸上做功夫──她想做出各种各样的笑模样来，一种一种地试着来，哪一种最能打动人，就使哪一种。	{'time': '1966', 'genre': 'literature', 'category': 'general fiction'}
百仲同志你看怎么样？”	{'time': '1966', 'genre': 'literature', 'category': 'general fiction'}
韩百仲饭没吃，脸也没洗，就跑了一圈，把一队的九户比较困难的烈军属都访问了。	{'time': '1966', 'genre': 'literature', 'category': 'general fiction'}
那位同志说：	{'time': '1966', 'genre': 'literature', 'category': 'general fiction'}
萧长春又问马之悦：	{'time': '1966', 'genre': 'literature', 'category': 'general fiction'}
马立本这样看事情，不仅不生焦淑红的气了，也不失望了，甚至还有点可怜焦淑红。	{'time': '1966', 'genre': 'literature', 'category': 'general fiction'}
乡党委会开到傍鸡叫，还争论得不可收场，不得不暂时停下来，让大家吃点东西，休息一下，再接着开。	{'time': '1966', 'genre': 'literature', 'category': 'general fiction'}
“昨天用这一套？	{'time': '1966', 'genre': 'literature', 'category': 'general fiction'}
韩百仲又跟马长山追问了一些细节，就离开了打麦场。	{'time': '1966', 'genre': 'literature', 'category': 'general fiction'}
公布预分方案那天，支部书记来串门儿，说了好半天，只有一句话提到牲口。	{'time': '1966', 'genre': 'literature', 'category': 'general fiction'}
这会儿，马小辫又听到一个他不愿听、害怕听，但是又想听到的声音，这声音响在东边。	{'time': '1966', 'genre': 'literature', 'category': 'general fiction'}
“经一事，长一智，这句话一点不错。	{'time': '1966', 'genre': 'literature', 'category': 'general fiction'}
我得先学这个，接着再学新的。”	{'time': '1966', 'genre': 'literature', 'category': 'general fiction'}
大庙里是最热闹的地方。	{'time': '1966', 'genre': 'literature', 'category': 'general fiction'}
焦淑红乐了：	{'time': '1966', 'genre': 'literature', 'category': 'general fiction'}
马立本这会儿已经梳洗完毕，又吃过了早饭，正隔着院子中间的寨子呼唤他的小弟弟：	{'time': '1966', 'genre': 'literature', 'category': 'general fiction'}
“您不是说，看看风向再抬腿吗？”	{'time': '1966', 'genre': 'literature', 'category': 'general fiction'}
“真正不够吃的还是有几户。”	{'time': '1966', 'genre': 'literature', 'category': 'general fiction'}
焦淑红说：	{'time': '1966', 'genre': 'literature', 'category': 'general fiction'}
孙桂英说：	{'time': '1966', 'genre': 'literature', 'category': 'general fiction'}
沟北来了个焊洋铁壶的，把摊子摆在坎子边上的小槐树下，叮叮当当的敲打声，招来了一群孩子，也把马凤兰招来了。	{'time': '1966', 'genre': 'literature', 'category': 'general fiction'}
每个赶集的人都有自己的目标。	{'time': '1966', 'genre': 'literature', 'category': 'general fiction'}
不料想，一进门就遇到这种情形，就听到爸爸这一套话，他还好意思开口吗？	{'time': '1966', 'genre': 'literature', 'category': 'general fiction'}
‘老四，快，快，搀着点吧，要不躺下了。	{'time': '1966', 'genre': 'literature', 'category': 'general fiction'}
踩地边子的事儿，让长山干吧！”	{'time': '1966', 'genre': 'literature', 'category': 'general fiction'}
小石头不高兴地摇晃着小脑袋：	{'time': '1966', 'genre': 'literature', 'category': 'general fiction'}
一个七、八岁的小姑娘戴着草帽，拿着棍子，坐在一边看守，几只鸡远远地围着笸箩转悠，瞅冷子就跑过来抢几口。	{'time': '1966', 'genre': 'literature', 'category': 'general fiction'}
“谁骗你不是人养的。	{'time': '1966', 'genre': 'literature', 'category': 'general fiction'}
这是福奶奶的声音。	{'time': '1966', 'genre': 'literature', 'category': 'general fiction'}
他说话的时候，从那花白的头顶上滑下两片麦鱼子。	{'time': '1966', 'genre': 'literature', 'category': 'general fiction'}
他认识这个石柱子；上边的“堂”字儿只剩下一半儿，“茔界”二字还清楚可辨。	{'time': '1966', 'genre': 'literature', 'category': 'general fiction'}
“你们昨晚上去没去呀？”	{'time': '1966', 'genre': 'literature', 'category': 'general fiction'}
“您干坐着的事儿，我干跑腿的事儿。”	{'time': '1966', 'genre': 'literature', 'category': 'general fiction'}
几个拾粪的老头和走读的完小学生，也绕个弯，跑来看热闹。	{'time': '1966', 'genre': 'literature', 'category': 'general fiction'}
临近了门口，就听到一片咯吱吱的嚼草声传过来，十分动听。	{'time': '1966', 'genre': 'literature', 'category': 'general fiction'}
只要把麦子一分下去，那就完了。	{'time': '1966', 'genre': 'literature', 'category': 'general fiction'}
那时候，行人走到离村五、六里地，就能看到这儿黑压压一片，就能听到这儿的松柏涛声。	{'time': '1966', 'genre': 'literature', 'category': 'general fiction'}
孔老头摸进屋里，点上了灯，又把空着的铺板收拾一下，这才出来，小心地把车子上的东西一趟一趟地搬进屋子里，随后又找来一块旧布要擦车子。	{'time': '1966', 'genre': 'literature', 'category': 'general fiction'}
“是我让她回去的，吃口东西，看看孩子，就手歇一歇；她还咬着牙，不想回去哪。”	{'time': '1966', 'genre': 'literature', 'category': 'general fiction'}
他的身上、眉毛上，全是白灰点子。	{'time': '1966', 'genre': 'literature', 'category': 'general fiction'}
又搞本位哪！”	{'time': '1966', 'genre': 'literature', 'category': 'general fiction'}
焦克礼、焦淑红和马翠清三个伙伴，离开了桥头，一边商量着地往村里走。	{'time': '1966', 'genre': 'literature', 'category': 'general fiction'}
“什么呢！”	{'time': '1966', 'genre': 'literature', 'category': 'general fiction'}
“参加党支部会的时候，支书让咱们用什么办法对待落后分子呀？”	{'time': '1966', 'genre': 'literature', 'category': 'general fiction'}
刚才韩德大从农业社办公室把萧长春叫走之后，马立本正好把现金交代完，又怒气冲冲地翻了一阵儿账本子，心里边忽地一动。	{'time': '1966', 'genre': 'literature', 'category': 'general fiction'}
马立本瞪焦淑红一眼，没动窝。	{'time': '1966', 'genre': 'literature', 'category': 'general fiction'}
这几年东山坞的中学生是不少，可是都在学校里，一心奔着上大学；回来的那一个半个，也都当了干部，让谁扔掉别的干部不当，坐到办公室来打算盘，谁也不会干，除了这些人哪，那还用说，连边也沾不上。	{'time': '1966', 'genre': 'literature', 'category': 'general fiction'}
“长山，你再详细地说说，早起来是怎么看见马小辫的。”	{'time': '1966', 'genre': 'literature', 'category': 'general fiction'}
“刚才我心里边已经开始打谱了，你别走，也帮我对对，回头再找百仲大舅和团支委们一块儿商量商量，随后就发动积极分子，用晌午休息的空子，让大家分头找一找真缺粮和假缺粮的户摸摸实际情况，跟中农户作宣传，给他们摆前途，讲政策，这些事做好了，以后的几个会开好才能保险。”	{'time': '1966', 'genre': 'literature', 'category': 'general fiction'}
闺女今年高中毕业，也要上大学了，也将要成为了不起的大人物了。	{'time': '1966', 'genre': 'literature', 'category': 'general fiction'}
其实，他的两只眼睛不住地盯着通往大湾的道儿，眼巴巴地等着两个人。	{'time': '1966', 'genre': 'literature', 'category': 'general fiction'}
“眼下是什么时候，乱子够多的了，再让他们闯出点乱子来，那不就乱上加乱了吗！”	{'time': '1966', 'genre': 'literature', 'category': 'general fiction'}
也不奇怪，满打满算，咱们这个国家刚从旧社会那个病秧子上边站起来才七年多一点儿。	{'time': '1966', 'genre': 'literature', 'category': 'general fiction'}
“不错，你把牛放的膘满肉肥，真是难得的好牛馆。	{'time': '1966', 'genre': 'literature', 'category': 'general fiction'}
干部们真够难的呀！	{'time': '1966', 'genre': 'literature', 'category': 'general fiction'}
德大呀，你也老大不小了，心里该装点事儿了，别总是孩子气儿的！”	{'time': '1966', 'genre': 'literature', 'category': 'general fiction'}
事情过去了好几天，啥时候想起来，心里边都是疼的。	{'time': '1966', 'genre': 'literature', 'category': 'general fiction'}
所有这一切，都应当让领导知道，都应当听听领导的意见，都需要领导帮他拿拿主意。	{'time': '1966', 'genre': 'literature', 'category': 'general fiction'}
萧长春也笑着摇摇头：	{'time': '1966', 'genre': 'literature', 'category': 'general fiction'}
他那喜形于色的神态好有一比；像一个到大野山上打草或者拾柴禾的小孩子，又渴又累地回到家，一见门锁着，又一回头，见妈妈提着水桶，或者端着什么好吃的东西，从老远的地方走来了。	{'time': '1966', 'genre': 'literature', 'category': 'general fiction'}
萧长春把焦克礼、韩小乐打发走了，又约上韩百仲和焦淑红两个人来到办公室里，继续商量着眼前的事情应当怎么处理才妥当。	{'time': '1966', 'genre': 'literature', 'category': 'general fiction'}
他家的底子你还不清楚哇！”	{'time': '1966', 'genre': 'literature', 'category': 'general fiction'}
“我还没去拿。”	{'time': '1966', 'genre': 'literature', 'category': 'general fiction'}
马翠清和焦克礼带领着青年们正在修补道路。	{'time': '1966', 'genre': 'literature', 'category': 'general fiction'}
马翠清喘着气，爬上一个坡子朝回走，又喊了一声，山崖又响起回音。	{'time': '1966', 'genre': 'literature', 'category': 'general fiction'}
这会儿他才知道，不要说手里拿着尖刀子，就是空着手到这儿来，也是扎眼的；在街上不论碰上个什么人，也不会轻易地把他放过去，真叫怕人哪！	{'time': '1966', 'genre': 'literature', 'category': 'general fiction'}
淑红：	{'time': '1966', 'genre': 'literature', 'category': 'general fiction'}
总的估计是正气上升，邪气倒退，那么，抓住时机，调动一切可以调动的积极因素，全力投入麦收准备工作，是当前压倒一切的中心任务了。	{'time': '1966', 'genre': 'literature', 'category': 'general fiction'}
这是马凤兰的声音。	{'time': '1966', 'genre': 'literature', 'category': 'general fiction'}
他决定马上去找萧长春，跟他商量商量，赶快追查这个马小辫。	{'time': '1966', 'genre': 'literature', 'category': 'general fiction'}
过手的账目、钱款太多，脑袋里记不下呀！”	{'time': '1966', 'genre': 'literature', 'category': 'general fiction'}
他的两只眼睛都潮乎乎的了。	{'time': '1966', 'genre': 'literature', 'category': 'general fiction'}
怎么个交易法呀？	{'time': '1966', 'genre': 'literature', 'category': 'general fiction'}
先召开个会，说道说道，动员大伙儿把心弄齐一点儿，要不我没法儿跟长春交差呀！	{'time': '1966', 'genre': 'literature', 'category': 'general fiction'}
他到这儿一瞧没有萧长春，心里又嘀咕开了：	{'time': '1966', 'genre': 'literature', 'category': 'general fiction'}
“我们旁听一下还不行吗？”	{'time': '1966', 'genre': 'literature', 'category': 'general fiction'}
等那会儿回来，马连福再重打锣鼓另开张，马连福一准要当个积极分子！	{'time': '1966', 'genre': 'literature', 'category': 'general fiction'}
克礼妈急忙问：	{'time': '1966', 'genre': 'literature', 'category': 'general fiction'}
萧长春迈过隔着他的一垄麦子，凑过来说：	{'time': '1966', 'genre': 'literature', 'category': 'general fiction'}
“人还免不了闹病呢，何况牲口。	{'time': '1966', 'genre': 'literature', 'category': 'general fiction'}
韩百仲接着说：	{'time': '1966', 'genre': 'literature', 'category': 'general fiction'}
“我看哪，还是让马翠清去合适。”	{'time': '1966', 'genre': 'literature', 'category': 'general fiction'}
他擦着脸，又匆匆忙忙地走到门口；见大门掩着，又到槽前看看，那头红骡子不在棚里了，当然也不会有马老四的影子。	{'time': '1966', 'genre': 'literature', 'category': 'general fiction'}
“我再出去打听打听吧。”	{'time': '1966', 'genre': 'literature', 'category': 'general fiction'}
接缝的地方是对针儿砌，沿着边又来了一趟跳三针，背襻是线拉锁，锁成一榴不断头的盘肠；每个口袋上绣了一个大字，是金黄色的丝线，绣了一个“保”字，又绣了一个“卫”字。	{'time': '1966', 'genre': 'literature', 'category': 'general fiction'}
淑红，我不能没有你，没有你，日月星辰就要失去光明，鲜花碧叶就要失去色彩，鸟语虫鸣就要失去声音，那么，淑红啊，一个胸怀壮志的年轻的生命，还有什么存在于这个世界上的必要呢？	{'time': '1966', 'genre': 'literature', 'category': 'general fiction'}
马之悦走进来，冲着她不怀好意地笑笑。	{'time': '1966', 'genre': 'literature', 'category': 'general fiction'}
他们明确了方向，看清了路线，壮了胆子，鼓了劲儿；他们在地头上、副业组、街头巷尾，或社员家里，跟别人谈心思，引着别人说自己过去不爱听的那些话。	{'time': '1966', 'genre': 'literature', 'category': 'general fiction'}
我问问你，烈军属抚恤金是怎么发的？”	{'time': '1966', 'genre': 'literature', 'category': 'general fiction'}
她望了望变化多端的天地，又撩着衣裳襟擦了擦脑门上的汗水；心里边挺着急，又挺纳闷儿。	{'time': '1966', 'genre': 'literature', 'category': 'general fiction'}
先奔厢屋，见里边确实没有人，就又进了北屋，一步迈上炕，拉开行李卷儿，把一只大双人枕头横垫在另一只小枕头上，给枕头盖上了被窝；又把壶啦，碗啦，烟袋荷包啦，全都摆在枕头旁边；随后又从后院端来一个尿盆子，往里边倒了点茶叶水，放在炕沿边下。	{'time': '1966', 'genre': 'literature', 'category': 'general fiction'}
“好吧。	{'time': '1966', 'genre': 'literature', 'category': 'general fiction'}
斗争给东山坞的社员们带来了胜利，也给他们带来了生活的愉快和劳动的劲头。	{'time': '1966', 'genre': 'literature', 'category': 'general fiction'}
焦二菊说：	{'time': '1966', 'genre': 'literature', 'category': 'general fiction'}
他骄傲吗？	{'time': '1966', 'genre': 'literature', 'category': 'general fiction'}
焦二菊往门口外边一站说：	{'time': '1966', 'genre': 'literature', 'category': 'general fiction'}
这个本来是老熟人，也拿上了官腔：	{'time': '1966', 'genre': 'literature', 'category': 'general fiction'}
焦二菊拍着手说：	{'time': '1966', 'genre': 'literature', 'category': 'general fiction'}
她把几件要洗的衣裳往盆子里一按，端着就朝外跑。	{'time': '1966', 'genre': 'literature', 'category': 'general fiction'}
“还有气人的哪。	{'time': '1966', 'genre': 'literature', 'category': 'general fiction'}
可是他没完。	{'time': '1966', 'genre': 'literature', 'category': 'general fiction'}
有错处就批评，有好处就表扬，不该不欠，没远没近。”	{'time': '1966', 'genre': 'literature', 'category': 'general fiction'}
险哪！	{'time': '1966', 'genre': 'literature', 'category': 'general fiction'}
萧长春两只手紧紧地抓住那个老式的电话筒，像是抓住了乡党委书记的手。	{'time': '1966', 'genre': 'literature', 'category': 'general fiction'}
“弯弯绕的鸡把社里的麦子糟蹋了，你知道不？”	{'time': '1966', 'genre': 'literature', 'category': 'general fiction'}
放了假，村子里反而显得更加繁忙：	{'time': '1966', 'genre': 'literature', 'category': 'general fiction'}
“你来得正好，帮我一下子。”	{'time': '1966', 'genre': 'literature', 'category': 'general fiction'}
老头子在回答老伴问话的时候，态度是平和的，这种子和又包含着一股子说不出来的故作镇静的味道，听他回答的人，反而比对待龇牙瞪眼发脾气的人还要紧张几分，好像后边紧跟着就要来个什么大的灾祸那么担心。	{'time': '1966', 'genre': 'literature', 'category': 'general fiction'}
这回要让群众知道，咱团员都是好样儿的，都是党的好助手，嘿！”	{'time': '1966', 'genre': 'literature', 'category': 'general fiction'}
小石头哭了几回要爸爸给捉一只鸟，爸爸都没有答应。	{'time': '1966', 'genre': 'literature', 'category': 'general fiction'}
那边的人摇摇晃晃地走着，听到前边马翠清的喊声，“咕咚”一下子摔倒了。	{'time': '1966', 'genre': 'literature', 'category': 'general fiction'}
“丢不了，准是上山捉鸟去，找不着道儿回不来了；您找个人把这葛条给弄回去，我找找他，保险找回来。”	{'time': '1966', 'genre': 'literature', 'category': 'general fiction'}
萧长春看到她的时候，胸口一热，赶紧迎过来，两眼紧紧地盯着焦二菊的嘴巴；他希望从这张嘴巴里蹦出这么一句话：	{'time': '1966', 'genre': 'literature', 'category': 'general fiction'}
焦二菊又回去，吆喝一下牲口，说：	{'time': '1966', 'genre': 'literature', 'category': 'general fiction'}
马之悦压住气，说：	{'time': '1966', 'genre': 'literature', 'category': 'general fiction'}
“我这会儿急着往他那儿跑不方便，”又忙改口说：	{'time': '1966', 'genre': 'literature', 'category': 'general fiction'}
他一边摆弄着桌子上的一支蘸水钢笔，一边像是自言自语地说：	{'time': '1966', 'genre': 'literature', 'category': 'general fiction'}
“长春这孩子，真是的，我是随口跟他说说，他就当大事儿办了！”	{'time': '1966', 'genre': 'literature', 'category': 'general fiction'}
淑红妈搓着手，不知再怎么引话说了。	{'time': '1966', 'genre': 'literature', 'category': 'general fiction'}
没有光的残月，已经坠落下去，让金泉河边上的树木遮住了半边，小星斗无精打采地这边闪一下子，那边跳一下子，院子里黑古隆咚，什么都看不清楚。	{'time': '1966', 'genre': 'literature', 'category': 'general fiction'}
就好像他自己做了什么坏事似地那么害怕，又好像他自己受了别人欺负似地那么生气，又好像他自己受了什么人的大好处那么感动；害怕、生气、感动，三股子情绪搅在一起，在他的胸膛里翻腾着。	{'time': '1966', 'genre': 'literature', 'category': 'general fiction'}
她朝炕里边挪了挪，先看看韩道满，朝他咬了咬牙，意思是：	{'time': '1966', 'genre': 'literature', 'category': 'general fiction'}
马老四连连摆手说：	{'time': '1966', 'genre': 'literature', 'category': 'general fiction'}
这是一个扩大会议，除了十一名团员，还吸收了九名积极分子。	{'time': '1966', 'genre': 'literature', 'category': 'general fiction'}
你瞧，今晚上在街头乘凉的人，在院子喝茶的人，全都议论著这件事儿，全都料想到，随着明天日头升起，东山坞要出现一个新的局面。	{'time': '1966', 'genre': 'literature', 'category': 'general fiction'}
“好好，里边坐吧。”	{'time': '1966', 'genre': 'literature', 'category': 'general fiction'}
这不是八杆子都打不着的事儿吗？”	{'time': '1966', 'genre': 'literature', 'category': 'general fiction'}
他的心情也是快活的，可是又有一点儿焦急的感觉。	{'time': '1966', 'genre': 'literature', 'category': 'general fiction'}
“可是你没想想，我正跟他对立着，这会儿已经公开了，出了人命，就是三岁的孩子，也得怀疑到我的头上。	{'time': '1966', 'genre': 'literature', 'category': 'general fiction'}
马子怀说：	{'time': '1966', 'genre': 'literature', 'category': 'general fiction'}
玉珍越想越待不住了，打算赶紧喂完猪，赶紧追上婆婆，看看到底儿是怎么回事儿。	{'time': '1966', 'genre': 'literature', 'category': 'general fiction'}
他来到沟北第一队的打麦场上。	{'time': '1966', 'genre': 'literature', 'category': 'general fiction'}
“我就看着焦淑红最理想！”	{'time': '1966', 'genre': 'literature', 'category': 'general fiction'}
就是铁石人，也要被这些话打动！	{'time': '1966', 'genre': 'literature', 'category': 'general fiction'}
所以，他既没看出来，也不会留神到这个人今天的神情是多么特别，没有，一点也没有。	{'time': '1966', 'genre': 'literature', 'category': 'general fiction'}
社会主义道路我们是走定了！	{'time': '1966', 'genre': 'literature', 'category': 'general fiction'}
焦淑红的两只手悠然自得地穿针、引线，她的心里，也跟花丝线似的，一根根，一条条，全都抽动起来；也许是因为心情忽然轻松了、愉快了的关系吧，不知怎么，又抽动了她跟萧长春连着的那一条线。	{'time': '1966', 'genre': 'literature', 'category': 'general fiction'}
“不凉，我得守着它。”	{'time': '1966', 'genre': 'literature', 'category': 'general fiction'}
问东院的韩德大，我才知道，这个该死的货在会上跟萧支书吵架了。	{'time': '1966', 'genre': 'literature', 'category': 'general fiction'}
焦振茂没有发雷霆，连个大气都没有吭，慌慌张张地进了屋子，在屋子里兜了一圈，又慌慌张张地走到院子，在院子里转了个弯儿，又回到屋里，拿起笤帚，放下烟篓，摸摸炕沿，扶扶高桌，两只手就像没处放似的。	{'time': '1966', 'genre': 'literature', 'category': 'general fiction'}
他隔着许多人，沿着柜台走着，观看货架子上的各种布匹。	{'time': '1966', 'genre': 'literature', 'category': 'general fiction'}
那些被社员们抢到场上的麦子，虽说都设法儿苫上了，雨这么大，又下这么久，会不会漏了雨呢？	{'time': '1966', 'genre': 'literature', 'category': 'general fiction'}
“你看看，我们核对了好几遍，问了好些人，证明一队的烈军属抚恤金里边有问题。	{'time': '1966', 'genre': 'literature', 'category': 'general fiction'}
“我去找他说理！	{'time': '1966', 'genre': 'literature', 'category': 'general fiction'}
要不然，马凤兰决不会轻易到他这儿来。	{'time': '1966', 'genre': 'literature', 'category': 'general fiction'}
他还跟我说，等马志新来了，不论他怎么活动，都不要随便跟他发生冲突，要等乡里的人来了再说。”	{'time': '1966', 'genre': 'literature', 'category': 'general fiction'}
“挑挑河泥，劳动劳动就不失眠了。	{'time': '1966', 'genre': 'literature', 'category': 'general fiction'}
他把要说的话在心里掂了掂，低声问：	{'time': '1966', 'genre': 'literature', 'category': 'general fiction'}
克礼妈说：	{'time': '1966', 'genre': 'literature', 'category': 'general fiction'}
“这样说话，真是肉锅煮元宵──混蛋！”	{'time': '1966', 'genre': 'literature', 'category': 'general fiction'}
马子怀被他吓了一跳：	{'time': '1966', 'genre': 'literature', 'category': 'general fiction'}
焦振丛不明白，马之悦到他家转一圈的用意是什么，要是为堵焦振丛的嘴，怎么连这件事情一字全不提呢？	{'time': '1966', 'genre': 'literature', 'category': 'general fiction'}
再一个是满足肚子。	{'time': '1966', 'genre': 'literature', 'category': 'general fiction'}
“立本哪，我看你跟焦淑红的事儿，可以一刀两断了！”	{'time': '1966', 'genre': 'literature', 'category': 'general fiction'}
我不服，我要上告！”	{'time': '1966', 'genre': 'literature', 'category': 'general fiction'}
“你说怎么个准备法呀？”	{'time': '1966', 'genre': 'literature', 'category': 'general fiction'}
托儿组暂时借用了五婶前院的陈老太太家。	{'time': '1966', 'genre': 'literature', 'category': 'general fiction'}
昨天你要是也用这一套多好哇，保险不会闹那么多的事儿了。”	{'time': '1966', 'genre': 'literature', 'category': 'general fiction'}
韩百仲皱皱眉头说：	{'time': '1966', 'genre': 'literature', 'category': 'general fiction'}
[干部们接受了喜老头的建议：	{'time': '1966', 'genre': 'literature', 'category': 'general fiction'}
志泉媳妇说：	{'time': '1966', 'genre': 'literature', 'category': 'general fiction'}
他要赶紧领着社员们拔庄稼、平地，把场做出来。	{'time': '1966', 'genre': 'literature', 'category': 'general fiction'}
可是这一回韩百仲被难住了，门板上画的是一个大圆圈，这个记号他还从来没见过。	{'time': '1966', 'genre': 'literature', 'category': 'general fiction'}
强迫这些家伙们劳动，增加了人手，也好看管。	{'time': '1966', 'genre': 'literature', 'category': 'general fiction'}
找谁去呢？	{'time': '1966', 'genre': 'literature', 'category': 'general fiction'}
“他妈的，我一把火，把麦子全烧光，烧成灰，叫穷小子们乐去吧！”	{'time': '1966', 'genre': 'literature', 'category': 'general fiction'}
这到底是怎么一回事儿呢？	{'time': '1966', 'genre': 'literature', 'category': 'general fiction'}
“我讲的都是实话。	{'time': '1966', 'genre': 'literature', 'category': 'general fiction'}
马大炮咧开大嘴一笑：	{'time': '1966', 'genre': 'literature', 'category': 'general fiction'}
马之悦忽然抖了抖精神，故意问：	{'time': '1966', 'genre': 'literature', 'category': 'general fiction'}
“弯弯绕在那儿借由头骂咱们农业社，克礼没有白让他骂吧？”	{'time': '1966', 'genre': 'literature', 'category': 'general fiction'}
“淑红姐，我干是干，可是，我还有个要求。”	{'time': '1966', 'genre': 'literature', 'category': 'general fiction'}
“你们捉的鸡呢？”	{'time': '1966', 'genre': 'literature', 'category': 'general fiction'}
别胡思乱想了，还是跟大伙儿一心一意地走正道儿吧。	{'time': '1966', 'genre': 'literature', 'category': 'general fiction'}
马之悦坐在炕沿下一块圆滑的石头上，两只仇视的眼睛，不停地在萧长春身上溜。	{'time': '1966', 'genre': 'literature', 'category': 'general fiction'}
“这叫什么话，孩子没了，还是小题大做呀！”	{'time': '1966', 'genre': 'literature', 'category': 'general fiction'}
五婶问：	{'time': '1966', 'genre': 'literature', 'category': 'general fiction'}
民兵们在星光下放哨巡逻，保卫着劳动果实……	{'time': '1966', 'genre': 'literature', 'category': 'general fiction'}
“当然算数。	{'time': '1966', 'genre': 'literature', 'category': 'general fiction'}
“下雨早着哪，你家里有什么东西怕淋着哇？”	{'time': '1966', 'genre': 'literature', 'category': 'general fiction'}
萧长春说干就干，兢兢业业，白天黑夜忙工作，家也顾不上；可是呢，他处处受马之悦的害，马之悦总想给他空桥走，总想把他推到泥坑子里去……	{'time': '1966', 'genre': 'literature', 'category': 'general fiction'}
这里人们的每一句话，都跟晌午萧长春对他谈的话碰在一起，汇在一块儿。	{'time': '1966', 'genre': 'literature', 'category': 'general fiction'}
焦克礼摇着扎在河里的脑袋，又用一只手，往后脑勺上撩了几把水。	{'time': '1966', 'genre': 'literature', 'category': 'general fiction'}
“我看完了就锁在柜里，他们谁也摸不着。	{'time': '1966', 'genre': 'literature', 'category': 'general fiction'}
过去队里召集会，都是队长站在高地方一喊一叫，来不来拉倒；新队长上任第一天，就挨门挨户地“请”，真显得有点新鲜。	{'time': '1966', 'genre': 'literature', 'category': 'general fiction'}
“那当然！”	{'time': '1966', 'genre': 'literature', 'category': 'general fiction'}
不论是不是这个会议的当然参加者，都来了，因为这边要开始的事情是特别吸引人的。	{'time': '1966', 'genre': 'literature', 'category': 'general fiction'}
“还没起来！”	{'time': '1966', 'genre': 'literature', 'category': 'general fiction'}
韩百仲拧上一锅子烟，朝萧长春跟前凑凑，说：	{'time': '1966', 'genre': 'literature', 'category': 'general fiction'}
开始七八个孩子，第二天又加了五个，还有两个刚会爬的，五婶一个人忙不过来，又把陈老太太给拉上了。	{'time': '1966', 'genre': 'literature', 'category': 'general fiction'}
“这么早就睡？	{'time': '1966', 'genre': 'literature', 'category': 'general fiction'}
在这个念过五经四书的富农看来，“大学生”是非常非常了不起的人物，特别是马志新，上通天，下通地，更加不简单。	{'time': '1966', 'genre': 'literature', 'category': 'general fiction'}
为几个杏儿，站在街上嚷嚷，多不好看。”	{'time': '1966', 'genre': 'literature', 'category': 'general fiction'}
“对，就按着你的意思做吧。”	{'time': '1966', 'genre': 'literature', 'category': 'general fiction'}
我的看法？	{'time': '1966', 'genre': 'literature', 'category': 'general fiction'}
马志德看了萧长春一眼，好像说：	{'time': '1966', 'genre': 'literature', 'category': 'general fiction'}
前两天，他们完全被动地猜测着一些闹问题人的行动，不愿意听别人说“没吃”、“缺粮”这样的话。	{'time': '1966', 'genre': 'literature', 'category': 'general fiction'}
大伙儿一齐动手，那可就快多了。”	{'time': '1966', 'genre': 'literature', 'category': 'general fiction'}
弯弯绕也不会因为马之悦的品德缺欠就在感情上有所疏远。	{'time': '1966', 'genre': 'literature', 'category': 'general fiction'}
马连福要躲清静去了，到工地上，该吃吃，该干干，该睡觉睡觉，等到麦子分完了，云雨风浪全过去了，再回来，省心省力，还省着出毛病。	{'time': '1966', 'genre': 'literature', 'category': 'general fiction'}
萧长春从凳子上跳下来，说：	{'time': '1966', 'genre': 'literature', 'category': 'general fiction'}
每个面人胸口窝都扎着一根针，针上边长了红锈。	{'time': '1966', 'genre': 'literature', 'category': 'general fiction'}
他看到的只是他们手里的鸡，没有看到人；实在，这些人从来没有放在他的眼里，今天更不能放在眼里了。	{'time': '1966', 'genre': 'literature', 'category': 'general fiction'}
快点去吧，他有好听的话，专门给你留着哪。”	{'time': '1966', 'genre': 'literature', 'category': 'general fiction'}
这会儿我马立本应当拿出男子汉的架势，伸出友谊之手，赶快地给焦淑红打气，让她勇敢再勇敢，跟我一块儿干……	{'time': '1966', 'genre': 'literature', 'category': 'general fiction'}
从萧长春这副假菩萨的样子看，他昨晚上估摸对了，不能给这个人软的。	{'time': '1966', 'genre': 'literature', 'category': 'general fiction'}
尽管萧长春和韩百仲给他揭发的问题都是事实，他半点都不接受，也不正眼看一看；他不承认一切，而且觉着是理直气壮的，完全应当的。	{'time': '1966', 'genre': 'literature', 'category': 'general fiction'}
他们都把自己得到的情况摆了摆，也把自己的想法摆了摆。	{'time': '1966', 'genre': 'literature', 'category': 'general fiction'}
于是，他又像一阵风似的甩着大步，顺着沟往东走，回到自己家里。	{'time': '1966', 'genre': 'literature', 'category': 'general fiction'}
萧长春问：	{'time': '1966', 'genre': 'literature', 'category': 'general fiction'}
王国忠制住了马之悦，贫农、下中农集合一块儿要扭转东山坞的局势这类重大的事件，他当然要知道，当然要过问，也当然先慌张。	{'time': '1966', 'genre': 'literature', 'category': 'general fiction'}
又怪声怪气地笑笑，“你表姨夫赶集去还没有回来，我得回家等着他去了。”	{'time': '1966', 'genre': 'literature', 'category': 'general fiction'}
“到里边来，里边有地方。”	{'time': '1966', 'genre': 'literature', 'category': 'general fiction'}
那个社会到底儿什么样，她不太清楚，可是，她敢对任何人肯定它“好”。	{'time': '1966', 'genre': 'literature', 'category': 'general fiction'}
“唉，说起来，那天也怪你表姨夫，喝了几杯猫尿，糊糊涂涂地走错了门儿，把你家当成我家，把张三当成李四了。	{'time': '1966', 'genre': 'literature', 'category': 'general fiction'}
雷鸣夹着电闪，电闪带着雷鸣。	{'time': '1966', 'genre': 'literature', 'category': 'general fiction'}
一阵急风骤雨过去，一切又静下来了；只听得雨丝儿“沙沙”，从每个院子流出来的雨水，汇在街上，哗哗地流着。	{'time': '1966', 'genre': 'literature', 'category': 'general fiction'}
“别磨蹭，越快越好，咱们来个速成的！”	{'time': '1966', 'genre': 'literature', 'category': 'general fiction'}
对，先这么办！	{'time': '1966', 'genre': 'literature', 'category': 'general fiction'}
唉，她有脸做，我都没脸说她！”	{'time': '1966', 'genre': 'literature', 'category': 'general fiction'}
萧长春让焦淑红给说笑了：	{'time': '1966', 'genre': 'literature', 'category': 'general fiction'}
那边还在吵。	{'time': '1966', 'genre': 'literature', 'category': 'general fiction'}
今天他起的特别早，工作劲头也特别足。	{'time': '1966', 'genre': 'literature', 'category': 'general fiction'}
他听到萧长春又写了材料，又要打电话，心想；要是让他跑在前边，对自己是极为不利的，不能不过问。	{'time': '1966', 'genre': 'literature', 'category': 'general fiction'}
被大车摇下来的麦秸子，有的零散在路上，被行人踩扁了，有的搭在豆角架和喇叭花秧子上，有的还挂在树枝上，摇摇摆摆；麦糠和灰尘掺在一块儿，在空中飞腾，落在一切可以着落的地方，那屋脊、墙头、青菜叶子，以及人们乘凉坐的石头上，没有一个地方不被罩上一层麦糠和麦鱼子，连那来往的行人身上、头上、眉毛上也不例外。	{'time': '1966', 'genre': 'literature', 'category': 'general fiction'}
“对付几天算几天，哪天我死了，你再换人；就是让我管两天，也算我管了社会主义的事儿。	{'time': '1966', 'genre': 'literature', 'category': 'general fiction'}
马子怀的女人打开门。	{'time': '1966', 'genre': 'literature', 'category': 'general fiction'}
“我把他托给德大妈了。	{'time': '1966', 'genre': 'literature', 'category': 'general fiction'}
果真是人。	{'time': '1966', 'genre': 'literature', 'category': 'general fiction'}
马连福这会儿是一心上工地了，媳妇怎么纠缠，他也不能动心。	{'time': '1966', 'genre': 'literature', 'category': 'general fiction'}
萧长春倒让他给闹蒙了。	{'time': '1966', 'genre': 'literature', 'category': 'general fiction'}
弯弯绕听着萧长春说话，看着萧长春的表情，心里边绕着弯子。	{'time': '1966', 'genre': 'literature', 'category': 'general fiction'}
她的心里一震：	{'time': '1966', 'genre': 'literature', 'category': 'general fiction'}
他两只手用力地端着独扇门，轻轻地打开了，又用脚尖儿沾地、提着脚后跟，走到堂屋，把后门轻轻拉开一道缝儿，探出脑袋，东瞧瞧，西望望。	{'time': '1966', 'genre': 'literature', 'category': 'general fiction'}
“你怎么这么特别呢？	{'time': '1966', 'genre': 'literature', 'category': 'general fiction'}
“你这不是明知故问吗！	{'time': '1966', 'genre': 'literature', 'category': 'general fiction'}
我马上去瞧瞧这个‘大将’好搬不好搬吧。”	{'time': '1966', 'genre': 'literature', 'category': 'general fiction'}
因此，他得强打精神，得积极，比过去更积极，好让大伙儿看看，他是“心地坦然”的。	{'time': '1966', 'genre': 'literature', 'category': 'general fiction'}
丈夫们都用一种矜持的、多情的眼光送她们走远。	{'time': '1966', 'genre': 'literature', 'category': 'general fiction'}
他们的每一句话，都像冲着马之悦来的，这也是意外。	{'time': '1966', 'genre': 'literature', 'category': 'general fiction'}
韩百仲胸口跳了起来，点了点头。	{'time': '1966', 'genre': 'literature', 'category': 'general fiction'}
“哎，长春，那边场上也歇间了？”	{'time': '1966', 'genre': 'literature', 'category': 'general fiction'}
怎么变化，怎么发展。	{'time': '1966', 'genre': 'literature', 'category': 'general fiction'}
这回对啦。”	{'time': '1966', 'genre': 'literature', 'category': 'general fiction'}
“乖乖们，起风了，回屋吧！”	{'time': '1966', 'genre': 'literature', 'category': 'general fiction'}
焦淑红吃惊地看了萧长春一眼，心想，一天一夜的工夫，他又变了。	{'time': '1966', 'genre': 'literature', 'category': 'general fiction'}
“我这儿有封信，顶重要顶重要的。	{'time': '1966', 'genre': 'literature', 'category': 'general fiction'}
“这儿不是讲话的地方，都别急着打听了，该让你们知道的时候，自然要告诉你们。”	{'time': '1966', 'genre': 'literature', 'category': 'general fiction'}
福奶奶质问马凤兰：	{'time': '1966', 'genre': 'literature', 'category': 'general fiction'}
真的，真去了？”	{'time': '1966', 'genre': 'literature', 'category': 'general fiction'}
铁打的汉子扛了五趟麦子，并没有感到一点儿累。	{'time': '1966', 'genre': 'literature', 'category': 'general fiction'}
“嘎巴干脆，痛快的不得了！”	{'time': '1966', 'genre': 'literature', 'category': 'general fiction'}
焦淑红拦住他：	{'time': '1966', 'genre': 'literature', 'category': 'general fiction'}
马之悦也要在杂乱的思绪里缕出一条线来。	{'time': '1966', 'genre': 'literature', 'category': 'general fiction'}
叙述了萧长春带领群众，反对土地分红的初步胜利；第二卷（第五十二至九十一章），讲述了斗争形势的进一步复杂，涉及全国反覆批斗争，又取得了进一步的胜利。	{'time': '1966', 'genre': 'literature', 'category': 'general fiction'}
“我听这儿通通地打鼓嘛！”	{'time': '1966', 'genre': 'literature', 'category': 'general fiction'}
一句话，是他们要至死跟我们当敌人，逼着我们，非斗争不可呀！”	{'time': '1966', 'genre': 'literature', 'category': 'general fiction'}
他总算咬着牙挺住了，像儿子那样挺住了；儿子那种大无畏的气魄，社员们那种火一般的情感，都在冲击着他的心；处处洋溢着的丰收喜悦和斗争热情，也在鼓舞着他的精神；经过了这场灾祸的考验，好像当年跟着担架队闯了一趟战火纷飞的疆场回来，他倒觉着自己比过去硬朗一些了。	{'time': '1966', 'genre': 'literature', 'category': 'general fiction'}
“干什么？”	{'time': '1966', 'genre': 'literature', 'category': 'general fiction'}
对啦，这一次当机立断地下了决策，是非常及时又非常正确的，年轻的支部书记信心非常足！	{'time': '1966', 'genre': 'literature', 'category': 'general fiction'}
他根本就没有把韩小乐放在眼里，焦淑红倒是一个敌手。	{'time': '1966', 'genre': 'literature', 'category': 'general fiction'}
还有那些好吃懒做的娘们，也应该‘化消极’。	{'time': '1966', 'genre': 'literature', 'category': 'general fiction'}
喜老头点了点头：	{'time': '1966', 'genre': 'literature', 'category': 'general fiction'}
“同志，从哪儿来？”	{'time': '1966', 'genre': 'literature', 'category': 'general fiction'}
马小辫压了压气，又凑到跟前问：	{'time': '1966', 'genre': 'literature', 'category': 'general fiction'}
马子怀坐下来，觉着被一股热腾腾的气息包围住了。	{'time': '1966', 'genre': 'literature', 'category': 'general fiction'}
你千万让他给带走，交给王书记，再转给县委。”	{'time': '1966', 'genre': 'literature', 'category': 'general fiction'}
又要团结，又要斗争，又要坚决，又不能过火，这是多么复杂呀！	{'time': '1966', 'genre': 'literature', 'category': 'general fiction'}
[太阳落山了，晚霞烧红了半边天。	{'time': '1966', 'genre': 'literature', 'category': 'general fiction'}
焦淑红已经在这儿陪着新会计熬过三个夜晚，每天晚上都要弄到半夜后才能结束。	{'time': '1966', 'genre': 'literature', 'category': 'general fiction'}
“小孩家晚上都是喝粥，哪有吃饼子的？	{'time': '1966', 'genre': 'literature', 'category': 'general fiction'}
喂，你再摸摸鸡窝，我堵上了没有哇！”	{'time': '1966', 'genre': 'literature', 'category': 'general fiction'}
他们把滚到路面上的石头子儿拣走，把坎子撤平，把洼地用土垫起来，窄的地方用镐朝两边展宽。	{'time': '1966', 'genre': 'literature', 'category': 'general fiction'}
我说支书，你们今天开干部会，明天开贫农会，开来开去，不办真事儿，不给我们解决问题，是要我的好看呀？”	{'time': '1966', 'genre': 'literature', 'category': 'general fiction'}
从那一回起，只要一想起这件事儿，他就悔恨，就惭愧，觉得对不起死去的，也对不起活着的，一直到农业合作化，全都过上了温饱的日子，他这股子心情才渐渐地消退了。	{'time': '1966', 'genre': 'literature', 'category': 'general fiction'}
焦淑红顺着寨子根，急步地朝北走着，忽听寨子那边有人打口哨，还有洋铁桶的铁环“吱吱”响，就停住了，扯着那纠缠在一块儿的喇叭花蔓子，扒开密密的秫秸秆儿，探头一看，那边走着的正是她要找的那个韩小乐。	{'time': '1966', 'genre': 'literature', 'category': 'general fiction'}
应该多往集体事儿上花点心思，别光打自己的小算盘，什么全不顾。	{'time': '1966', 'genre': 'literature', 'category': 'general fiction'}
“我是就着星星喝的迷魂汤，趁着月亮吃的糊涂药，狗吃日头那会儿，我把白天当黑夜。	{'time': '1966', 'genre': 'literature', 'category': 'general fiction'}
马之悦比他们这伙中的哪一个都清楚，如果不设法儿把头边摆着的这些灾难化开，人家就会把他连根拔掉，就会使他从此彻底完蛋，别的人对眼前已经发生了、又在发生着的事儿，都还抱着一点碰运气的想法，马之悦却觉着自己已经迈上了悬崖绝壁，走到了早春二月的薄冰上，随时随地都可能滚到沟里、掉到水里。	{'time': '1966', 'genre': 'literature', 'category': 'general fiction'}
马立本踢开那糟朽的寨子，蹿过来了。	{'time': '1966', 'genre': 'literature', 'category': 'general fiction'}
这一来，场上的人才开始慌了。	{'time': '1966', 'genre': 'literature', 'category': 'general fiction'}
回头，我再让你舅妈跟着干去。	{'time': '1966', 'genre': 'literature', 'category': 'general fiction'}
这会儿，都在那儿庄严地坐着，等着几个还没有来到的人，耳朵却在注意地听着窗里窗外人们的议论。	{'time': '1966', 'genre': 'literature', 'category': 'general fiction'}
东山坞的好多人都赶集来了。	{'time': '1966', 'genre': 'literature', 'category': 'general fiction'}
咱们等着闹一块孝布戴戴吧。”	{'time': '1966', 'genre': 'literature', 'category': 'general fiction'}
他不住地朝场边的路上张望，看着行人的踪影，耳朵也用劲儿地听着村子里的动静，心里边估计着孩子的去向，以及可能发生的意外。	{'time': '1966', 'genre': 'literature', 'category': 'general fiction'}
可是，一种杀人行凶的毒火烧着他，他不仅忘了冷雨，也忘了一切生死的危险。	{'time': '1966', 'genre': 'literature', 'category': 'general fiction'}
啊？”	{'time': '1966', 'genre': 'literature', 'category': 'general fiction'}
场上的人把场板扫干净，也摊晒上了，焦淑红和萧长春站在垛边上说了一阵子话儿，就跑到场房门口找马翠清。	{'time': '1966', 'genre': 'literature', 'category': 'general fiction'}
正在干活的人，看到他们，也都凑过来了。	{'time': '1966', 'genre': 'literature', 'category': 'general fiction'}
他是地主马小辫。	{'time': '1966', 'genre': 'literature', 'category': 'general fiction'}
“大姐夫，吃了吗？”	{'time': '1966', 'genre': 'literature', 'category': 'general fiction'}
“你们别乱动嘴，让队长说，他怎么说就怎么办。	{'time': '1966', 'genre': 'literature', 'category': 'general fiction'}
马之悦早晨从炕上爬起来，喝了一碗凉茶，饭也没吃，就按着韩百仲半夜后给他下的“通知”，急急忙忙地来到一队的打麦场上。	{'time': '1966', 'genre': 'literature', 'category': 'general fiction'}
“套车干什么？	{'time': '1966', 'genre': 'literature', 'category': 'general fiction'}
他没有因为听到这件意外的丑事有所震动，也没有感到意外；马之悦这个花花公子，过去少搞破鞋啦！	{'time': '1966', 'genre': 'literature', 'category': 'general fiction'}
这麦子的产量会怎么往上报呢？	{'time': '1966', 'genre': 'literature', 'category': 'general fiction'}
乡里的整风准备会一直没有开成，他写的“翻案”材料也还没有定稿；乱七八糟的事情，一个接着一个地跟着来，在这晚饭前光电话就接了三个。	{'time': '1966', 'genre': 'literature', 'category': 'general fiction'}
明摆着嘛！	{'time': '1966', 'genre': 'literature', 'category': 'general fiction'}
门口外边响起了脚步声。	{'time': '1966', 'genre': 'literature', 'category': 'general fiction'}
有人怕光膀子麦芒扎肉，他不在乎，那古铜色的脊梁上好似刷了一层桐油闪着亮；有人怕光着脚热土发烫，他也不在乎，那双有力的大脚厂子，把土块块跺成窝，碾成粉……	{'time': '1966', 'genre': 'literature', 'category': 'general fiction'}
“马主任，马主任，快，快！”	{'time': '1966', 'genre': 'literature', 'category': 'general fiction'}
从打小麦预分方案公布以后，东山坞的情况大变，好多人都是轻轻爽爽的了，唯独他们这一伙，精神上那块石头越来越沉重，一个个就像拉秧的黄瓜卸架的烟，蔫聋聋的头也抬不起来。	{'time': '1966', 'genre': 'literature', 'category': 'general fiction'}
“武装部长的意见，在我到家之前，你们先开个党委会，我看可以开。	{'time': '1966', 'genre': 'literature', 'category': 'general fiction'}
喜老头问：	{'time': '1966', 'genre': 'literature', 'category': 'general fiction'}
萧长春推开说：	{'time': '1966', 'genre': 'literature', 'category': 'general fiction'}
水桶里滴洒出来的水点儿，一溜一行、弯弯曲曲，从每一家门口，连到官井沿上……	{'time': '1966', 'genre': 'literature', 'category': 'general fiction'}
马立本明知她这个屋子外人是进不去的，只好停住说：	{'time': '1966', 'genre': 'literature', 'category': 'general fiction'}
只要是夜间，不用说是阴雨，就是大好的月亮，贴在墙上不动，也瞧不见；就是从旁边走过去，也甭想发现，太保险了。	{'time': '1966', 'genre': 'literature', 'category': 'general fiction'}
“又来一个，让她评评谁的办法对吧！”	{'time': '1966', 'genre': 'literature', 'category': 'general fiction'}
麦收是最忙最乱的时刻，随时都会出岔子，他不能让萧长春为所欲为地、顺顺当当地把麦子打到场上、装到仓里，最后分到每一个社员的手内；他得找空子，看风向，作一番挽回局势的努力，不能成为“瓮中之鳖”，最后由着人家一伸手就抓起来……	{'time': '1966', 'genre': 'literature', 'category': 'general fiction'}
萧老大在一旁说：	{'time': '1966', 'genre': 'literature', 'category': 'general fiction'}
业务员手摇着那个货郎鼓“叮铃铃，叮铃铃”地一响，那些做针线、哄孩子的闺女、媳妇们，立刻就你呼我叫，成群结伴地围过来了。	{'time': '1966', 'genre': 'literature', 'category': 'general fiction'}
“千万别寄，要交给内部交通，让他交给王书记。	{'time': '1966', 'genre': 'literature', 'category': 'general fiction'}
韩小乐的脸上却一点儿笑模样都没有，又说：	{'time': '1966', 'genre': 'literature', 'category': 'general fiction'}
那会儿只是因为欲望不得满足而焦急痛苦，如今，又添了一层可怕的担忧。	{'time': '1966', 'genre': 'literature', 'category': 'general fiction'}
“往日里，哑叭早到山上转半天了，可今天，都半晌午了，连羊还没有撒哪……”	{'time': '1966', 'genre': 'literature', 'category': 'general fiction'}
新队长把身上那件脏了的小褂子一扒、一团，扔在河岸的草地上，随后往水边上一蹲，两只手扶着地，把身子朝下一趴，又把脑瓜子朝下一低，就扎到水里去了。	{'time': '1966', 'genre': 'literature', 'category': 'general fiction'}
“是呀。	{'time': '1966', 'genre': 'literature', 'category': 'general fiction'}
除了靠西边那个八仙桌子旁边的几个干部坐在凳子上，其余的人全都打地摊；有的坐着木头，有的坐着砖块儿，年轻人不爱坐，靠墙站着。	{'time': '1966', 'genre': 'literature', 'category': 'general fiction'}
“浇菜。	{'time': '1966', 'genre': 'literature', 'category': 'general fiction'}
他跟最后一个“拦路”的人谈完之后，就急忙下了坎，过了沟。	{'time': '1966', 'genre': 'literature', 'category': 'general fiction'}
“你看人家长春，一点也不懵。	{'time': '1966', 'genre': 'literature', 'category': 'general fiction'}
她按照风俗，作了一番打扮：	{'time': '1966', 'genre': 'literature', 'category': 'general fiction'}
“够了。	{'time': '1966', 'genre': 'literature', 'category': 'general fiction'}
才过小桥子，见远远的麦地里有两个人脸对脸地站着说话儿哪。	{'time': '1966', 'genre': 'literature', 'category': 'general fiction'}
她没有着过急，也没有害过怕，更没有纠缠过自己的事儿，真是干干净净，利利索索。	{'time': '1966', 'genre': 'literature', 'category': 'general fiction'}
“那就列个人名单儿，挨个儿找，一个也别剩下他们。	{'time': '1966', 'genre': 'literature', 'category': 'general fiction'}
于是，他到这里来告别。	{'time': '1966', 'genre': 'literature', 'category': 'general fiction'}
“喂，你怎么啦？”	{'time': '1966', 'genre': 'literature', 'category': 'general fiction'}
这会儿，关键在于快点找到证据，让弯弯绕、马大炮这伙子人低头认罪！	{'time': '1966', 'genre': 'literature', 'category': 'general fiction'}
比方说，马翠清和韩道满两个人，也许没有看出什么破绽，干自己的事情去了，也许很重视刚才的动静，去报告萧长春。	{'time': '1966', 'genre': 'literature', 'category': 'general fiction'}
你不用发愁，这件事儿最好办。	{'time': '1966', 'genre': 'literature', 'category': 'general fiction'}
来来，我手湿，你自己掏吧，在左边那个裤兜子里。	{'time': '1966', 'genre': 'literature', 'category': 'general fiction'}
屋里的三个人，就像等着什么似的闷声不语，那空气又沉重又紧张。	{'time': '1966', 'genre': 'literature', 'category': 'general fiction'}
孙桂英又一连声地答应着，见马翠清带着一串笑跑了，急忙从锅里往外舀粥，又放桌子，又拿碟子，忽然又觉着这么斯斯文文的不像个干活人的样儿，就盛了一碗粥，夹了几根咸菜坐在锅台上吃起来。	{'time': '1966', 'genre': 'literature', 'category': 'general fiction'}
“瞧着做吧。”	{'time': '1966', 'genre': 'literature', 'category': 'general fiction'}
对不对？”	{'time': '1966', 'genre': 'literature', 'category': 'general fiction'}
那麦子垛有漏的没有？”	{'time': '1966', 'genre': 'literature', 'category': 'general fiction'}
他走出大门口，心里不由得一动：	{'time': '1966', 'genre': 'literature', 'category': 'general fiction'}
现在要分别，他得利用这个机会开导儿子几句。	{'time': '1966', 'genre': 'literature', 'category': 'general fiction'}
马凤兰更加轻薄的露骨了：	{'time': '1966', 'genre': 'literature', 'category': 'general fiction'}
主意打定，就来找儿子商量。	{'time': '1966', 'genre': 'literature', 'category': 'general fiction'}
早上，马小辫把杀人的念头和行动的安排跟马凤兰一说，这个胖女人哆嗦了一阵子之后，立刻就全盘赞成了。	{'time': '1966', 'genre': 'literature', 'category': 'general fiction'}
社员代表们到的差不离儿了，各人找到自己合适的座位和可以说到一起的人，就闲谈起来了。	{'time': '1966', 'genre': 'literature', 'category': 'general fiction'}
这个“惊慌”的头儿，是从沟北边、跟狮子院隔着一条小胡同的那个小院子里发起的。	{'time': '1966', 'genre': 'literature', 'category': 'general fiction'}
“你先走一步吧，我把孩子安置一下就跟上。”	{'time': '1966', 'genre': 'literature', 'category': 'general fiction'}
他回到屋里，摸摸鸡蛋，也是温乎乎的，一个手心托着一个看看，把一个掖在衣兜里，把另一个又放回盘子里；接着，又把黄瓜一折两截儿，把头上那截儿放到桌子上，就攥着尾巴那截儿咬了一口；一边咬着，一边朝外走。	{'time': '1966', 'genre': 'literature', 'category': 'general fiction'}
要是真这样了，萧老大该怎么闹呀，萧长春该怎么受呀？	{'time': '1966', 'genre': 'literature', 'category': 'general fiction'}
一个人走进来了。	{'time': '1966', 'genre': 'literature', 'category': 'general fiction'}
“你瞧瞧，这是啥时候，它偏偏闹病，这全是我的过失呀！”	{'time': '1966', 'genre': 'literature', 'category': 'general fiction'}
马子怀却从这微笑里得到了他想要得到的东西，身上来劲儿了，那杈子在他手上挥动得更快、更灵活。	{'time': '1966', 'genre': 'literature', 'category': 'general fiction'}
这里那里，不断地爆发着笑声。	{'time': '1966', 'genre': 'literature', 'category': 'general fiction'}
往那铺着布垫的椅子上一坐，伸在桌子底下的两条腿，不住地抖动着打着点儿；一只胳膊肘拄着桌子，手托着腮帮子，另一只手悠然地拨拉着算盘珠儿；一会儿，又推开算盘，望着玻璃板底下压着的照片、纪念邮票出会儿神，在账本子上划两笔，一会儿，又离开座位，把耳机子套在头上，听一阵子音乐；一会儿，又提过暖壶，往那个花瓷的茶杯里兑一点开水，“滋咂”地喝了一口，心满意足地抹了抹嘴唇儿……	{'time': '1966', 'genre': 'literature', 'category': 'general fiction'}
马老四站在灯下、槽前，一只胳膊搂着病骡子的脖子，一只手轻轻地抚摸着病骡子的脑门儿；雨水像一条条珠子串似的，从檐头上垂落下来，在老人家的肩头上摔碎了，跌在脚下旋转的水涡里。	{'time': '1966', 'genre': 'literature', 'category': 'general fiction'}
“不光是听，根据过去的情形看，也会是这个样子。”	{'time': '1966', 'genre': 'literature', 'category': 'general fiction'}
满山的绿色不止一回把他和穷哥儿们从春荒的死亡里拯救过来。	{'time': '1966', 'genre': 'literature', 'category': 'general fiction'}
她跑到沟北狮子院，找帮忙的人。	{'time': '1966', 'genre': 'literature', 'category': 'general fiction'}
前些日子，阴险、狡猾的地主闺女马凤兰，在孙桂英的心里塞了一团“柴禾”，昨天在河边上的一片话，又像往这“柴禾”上浇了一桶子棉籽油；回到家，这条没有翅膀就飞到手里的毛巾，给这把“柴禾”加了热，烘干了，刚才她一番露骨的精神挑逗和引诱，像一根火柴似地把“柴禾”“腾”下子点着了。	{'time': '1966', 'genre': 'literature', 'category': 'general fiction'}
平时他不大讲究穿戴，只是愿意骑好车子、使好笔，这是为了工作方便；另外，也喜欢吃一点可口的，这又为的身休健康──他的身体不算不健康，却又不断地闹点病，药瓶子、药包儿常年不离身，一年得有半年在家里休养。	{'time': '1966', 'genre': 'literature', 'category': 'general fiction'}
在东山坞这场剧烈、复杂的斗争波涛里，他那全身的精神力量又被大大地鼓动起来了。	{'time': '1966', 'genre': 'literature', 'category': 'general fiction'}
有一堆人谈着马立本下台、韩小乐接手当会计的事儿：	{'time': '1966', 'genre': 'literature', 'category': 'general fiction'}
我把饭吃了，不见他回来，就干活儿去了；我想，放假的日子，多睡会儿就让他多睡会儿，谁想，唉，我那道满……”	{'time': '1966', 'genre': 'literature', 'category': 'general fiction'}
一群黄毛丫头、半头小子，哪里是马之悦的对手？	{'time': '1966', 'genre': 'literature', 'category': 'general fiction'}
“谁说不是呢。”	{'time': '1966', 'genre': 'literature', 'category': 'general fiction'}
“马小辫也不一定会把自己的底子全让马志德知道。	{'time': '1966', 'genre': 'literature', 'category': 'general fiction'}
这一段“艰难的行程”，在他的感觉里，简直比爬一趟瞪眼岭还要费力气。	{'time': '1966', 'genre': 'literature', 'category': 'general fiction'}
这一老一少，躺在一条炕上，各人想着各人的心事，好久都没有睡着。	{'time': '1966', 'genre': 'literature', 'category': 'general fiction'}
为了动员这个胖女人参加劳动，整整蘑菇了好半天，先是福奶奶，后来又搬去了喜老头。	{'time': '1966', 'genre': 'literature', 'category': 'general fiction'}
“那还用说，他早就跟地主一个心眼儿了。”	{'time': '1966', 'genre': 'literature', 'category': 'general fiction'}
一会儿工作安排定了，您得快到乡里去报告，得靠领导帮着咱们破案。”	{'time': '1966', 'genre': 'literature', 'category': 'general fiction'}
萧长春在屋里装了烟，又拿了一把锄头，就匆忙地朝外走。	{'time': '1966', 'genre': 'literature', 'category': 'general fiction'}
不会！	{'time': '1966', 'genre': 'literature', 'category': 'general fiction'}
她一口气跑到山坡下，钻过树林里，又爬上石岗子上；到处找，到处喊：	{'time': '1966', 'genre': 'literature', 'category': 'general fiction'}
“小挨刀的，人家两口子说话，你也偷着听！	{'time': '1966', 'genre': 'literature', 'category': 'general fiction'}
要是拖到分了麦子，王国忠再突然一来，他们把马之悦的事儿先在群众里边一抖落，那算臭了，一点翻身抬头的希望都没有了，十成有八成让他们一撸到底，说不定变成劳改犯。	{'time': '1966', 'genre': 'literature', 'category': 'general fiction'}
可是他们三个人，对这次会议的想法并不是完全一样的。	{'time': '1966', 'genre': 'literature', 'category': 'general fiction'}
他正在焦淑红家的屋子里，跟焦振茂老头子议论著这件事儿：	{'time': '1966', 'genre': 'literature', 'category': 'general fiction'}
“不给人留活路了！”	{'time': '1966', 'genre': 'literature', 'category': 'general fiction'}
当时焦克礼就指出他这是破坏农业社生产，有意捣乱。”	{'time': '1966', 'genre': 'literature', 'category': 'general fiction'}
这是一件多么奇怪的事情！	{'time': '1966', 'genre': 'literature', 'category': 'general fiction'}
韩道满当是让他给掏手巾，伸手在裤兜里摸着：	{'time': '1966', 'genre': 'literature', 'category': 'general fiction'}
“没见过，哪能想到有这一节儿。”	{'time': '1966', 'genre': 'literature', 'category': 'general fiction'}
萧长春不再喊叫了，就用手轻轻地摇晃着门板儿。	{'time': '1966', 'genre': 'literature', 'category': 'general fiction'}
炕桌上的玻璃罩子灯放着昏暗的光，那光投到墙上，像贫血人的脸。	{'time': '1966', 'genre': 'literature', 'category': 'general fiction'}
村子里好多人家的门口外边都有一堆人，都在议论著这件事儿。	{'time': '1966', 'genre': 'literature', 'category': 'general fiction'}
她觉着，从打回到家乡，这一次团支部会议收获最大。	{'time': '1966', 'genre': 'literature', 'category': 'general fiction'}
“党怎么安排的，咱们就怎么做，好吧？”	{'time': '1966', 'genre': 'literature', 'category': 'general fiction'}
李秀敏一边刷锅，一边回答：	{'time': '1966', 'genre': 'literature', 'category': 'general fiction'}
干部一开会，非得半夜才能散；社员干一天活儿，全累得爬不起来了，趁这空儿，先溜进大庙去，等到村里安静下来，就下家伙！	{'time': '1966', 'genre': 'literature', 'category': 'general fiction'}
第一个迎着支部书记的人是队长焦克礼。	{'time': '1966', 'genre': 'literature', 'category': 'general fiction'}
他拄着棍子，从沟北来到沟南，来到韩百仲家的小院子里。	{'time': '1966', 'genre': 'literature', 'category': 'general fiction'}
几条道儿一齐走，总可以找出眉目来。	{'time': '1966', 'genre': 'literature', 'category': 'general fiction'}
麦子打到场上了，得特别地加小心才行；妇女劳力也别剩下，不管干多干少，能添上几只手总比没有强。”	{'time': '1966', 'genre': 'literature', 'category': 'general fiction'}
哑叭把马老四上上下下看了一阵子，又在院子里转了一遭儿，回来就比划着问：	{'time': '1966', 'genre': 'literature', 'category': 'general fiction'}
他想把这位老太太接去，不独是让她帮助孙桂英照看孩子，也想通过这个受过苦难的老人趁孙桂英正在动摇的火候上给使把子劲儿，把孙桂英稳在正道上。	{'time': '1966', 'genre': 'literature', 'category': 'general fiction'}
打麦子的时候，派到场上干活的人，我选了几个，你看行不行？”	{'time': '1966', 'genre': 'literature', 'category': 'general fiction'}
我去踩踩地边子，看看哪块地先动镰，哪块地分给哪一组干；还有场上的人也没有选定，还得跟小组长们凑凑名单儿；新记工册子，也得发下去；哪几辆车给咱队拉麦子，也得找运输组商量；重要的是场上……”	{'time': '1966', 'genre': 'literature', 'category': 'general fiction'}
别急，你有什么话，就跟我说吧。”	{'time': '1966', 'genre': 'literature', 'category': 'general fiction'}
过午你找我。”	{'time': '1966', 'genre': 'literature', 'category': 'general fiction'}
萧长春蹲在用土坯垒的火炕上边，两只愤怒的眼睛，紧紧地盯着马之悦。	{'time': '1966', 'genre': 'literature', 'category': 'general fiction'}
于是，她这些日子走动得比任何时候都勤。	{'time': '1966', 'genre': 'literature', 'category': 'general fiction'}
小清说：	{'time': '1966', 'genre': 'literature', 'category': 'general fiction'}
贫农更得铁了心，中农也不会再热心地跟着自己干了，马之悦想在东山坞开展一个变天的试点，跟城市配合起来，给自己闯出另一个天下，全都困难了。	{'time': '1966', 'genre': 'literature', 'category': 'general fiction'}
他们都被一种特殊的力量鼓动着，恨不能把全身的劲儿都拿出来。	{'time': '1966', 'genre': 'literature', 'category': 'general fiction'}
走呀！”	{'time': '1966', 'genre': 'literature', 'category': 'general fiction'}
“长春倒是压住阵了，全和平了？”	{'time': '1966', 'genre': 'literature', 'category': 'general fiction'}
村里故意闹事，故意跟儿子为难的那群人，拙戏法揭了盖子，这群人的气焰，像一下子浇了场暴雨似的，光剩下一堆灰了。	{'time': '1966', 'genre': 'literature', 'category': 'general fiction'}
这个墙角是萧家和焦庆家两家的。	{'time': '1966', 'genre': 'literature', 'category': 'general fiction'}
马立本着急地说，“这还假的了！	{'time': '1966', 'genre': 'literature', 'category': 'general fiction'}
随着声音，走出一个五十多岁的老太太。	{'time': '1966', 'genre': 'literature', 'category': 'general fiction'}
“嗳，这还差不离儿！	{'time': '1966', 'genre': 'literature', 'category': 'general fiction'}
“谁跟你说这个呀！	{'time': '1966', 'genre': 'literature', 'category': 'general fiction'}
马长山说：	{'time': '1966', 'genre': 'literature', 'category': 'general fiction'}
常言说：	{'time': '1966', 'genre': 'literature', 'category': 'general fiction'}
马之悦太悲观了。	{'time': '1966', 'genre': 'literature', 'category': 'general fiction'}
他刚把纸铺好，从大门外边进来一群推着自行车的人。	{'time': '1966', 'genre': 'literature', 'category': 'general fiction'}
夜里马之悦到乡里来，他听到许多过去没有听到的情况，觉得下边的干部和群众的情形很乱，心里郁郁闷闷，好久睡不着，吃了两片安眠药也没有顶用。	{'time': '1966', 'genre': 'literature', 'category': 'general fiction'}
“你瞧瞧，来了吧？	{'time': '1966', 'genre': 'literature', 'category': 'general fiction'}
韩百安一拍大腿说：	{'time': '1966', 'genre': 'literature', 'category': 'general fiction'}
“表册上都有，一会儿我给您查查看。”	{'time': '1966', 'genre': 'literature', 'category': 'general fiction'}
“我肚子有点疼，走不动道儿。	{'time': '1966', 'genre': 'literature', 'category': 'general fiction'}
他回屋找了根粗麻绳，交给马立本提着，两个人就出了院子，跟门口外边的马凤兰一起朝东走。	{'time': '1966', 'genre': 'literature', 'category': 'general fiction'}
你家五口人，不分大小，全都跟村里的成年人一样，分得足够的口粮。	{'time': '1966', 'genre': 'literature', 'category': 'general fiction'}
萧老大随手带上了栅栏门，穿过小胡同，又下了沟，抬头一看，北坎子上站着一个人。	{'time': '1966', 'genre': 'literature', 'category': 'general fiction'}
东山坞今晚上这个会议是个不平常的会议，会场内外的好多人都受到了它的鼓舞。	{'time': '1966', 'genre': 'literature', 'category': 'general fiction'}
淑红，是什么力量，什么障碍，不能使我们成为真正有情的人呢？	{'time': '1966', 'genre': 'literature', 'category': 'general fiction'}
“支书，你不知道，这家人嘴上老实，心可毒啦，我没少受他们的气。	{'time': '1966', 'genre': 'literature', 'category': 'general fiction'}
忽地，她的心里一动，好多忘记了的往事，不知怎么回事儿，一下子涌到了她的心头上来了。	{'time': '1966', 'genre': 'literature', 'category': 'general fiction'}
有力气的庄稼汉，挤热闹是最不在行的。	{'time': '1966', 'genre': 'literature', 'category': 'general fiction'}
他忽然想到，焦淑红这个时候准在西边苗圃里，不如到那儿去一趟；一面跟焦淑红说话，一面瞧着路上，见客人来了再回办公室一点也不晚。	{'time': '1966', 'genre': 'literature', 'category': 'general fiction'}
真的，说假话不是人！”	{'time': '1966', 'genre': 'literature', 'category': 'general fiction'}
焦克礼的新媳妇玉珍跑进来了：	{'time': '1966', 'genre': 'literature', 'category': 'general fiction'}
东山坞村南的金泉河边上，这会儿是最热闹的地方了。	{'time': '1966', 'genre': 'literature', 'category': 'general fiction'}
因为它们出了名，过去人们都叫这儿狮子院。	{'time': '1966', 'genre': 'literature', 'category': 'general fiction'}
“呸，什么规定，那是给咱们中农戴在脑袋上的紧箍咒，你还想把它戴着进棺材呀！”	{'time': '1966', 'genre': 'literature', 'category': 'general fiction'}
“又翻你那些陈谷子烂芝麻的破纸片子干什么呀！	{'time': '1966', 'genre': 'literature', 'category': 'general fiction'}
说着，从发髻上拔下一根头发叉子，在土窗合上认真地划着那个生字儿，韩百仲假装凑过来看，冷不防使劲儿把焦二菊一推，就从她腿底下把那件东西抢过来了；展开一看，心里不由得一动，原来是巴掌那么大的一本书，红布夹纸的皮儿，里边包着的是冀东党委编印的《党员课本》，因为经历的年限很久，本来就很粗糙的纸张，这会儿都已经发黄了。	{'time': '1966', 'genre': 'literature', 'category': 'general fiction'}
焦淑红把篮子从这只胳膊换到那只胳膊上，说：	{'time': '1966', 'genre': 'literature', 'category': 'general fiction'}
忽见坡子底下有一团灰不溜秋的东西正在那儿活动。	{'time': '1966', 'genre': 'literature', 'category': 'general fiction'}
“弯弯绕故意反抗领导，存心破坏农业社的生产！	{'time': '1966', 'genre': 'literature', 'category': 'general fiction'}
话语之间，不知不觉地露了馅儿，把个马之悦也多少地捎上了一点儿。	{'time': '1966', 'genre': 'literature', 'category': 'general fiction'}
要是麦子这会儿在水里泡着，我这会儿就不是发愁了，我哭也哭不上韵调了。”	{'time': '1966', 'genre': 'literature', 'category': 'general fiction'}
‘往饲养场放个盆子，啥时候有了驴肉，让老四给我留点儿，开开荤！	{'time': '1966', 'genre': 'literature', 'category': 'general fiction'}
“哟，这是怎么回事儿？	{'time': '1966', 'genre': 'literature', 'category': 'general fiction'}
你这是自找！”	{'time': '1966', 'genre': 'literature', 'category': 'general fiction'}
早晨起得特别早，除了弯弯绕说头疼，马大炮说肚子疼之外，全队能干活的社员，差不多全让他招呼出来了。	{'time': '1966', 'genre': 'literature', 'category': 'general fiction'}
“我想灭了他，你就好办事儿了……”	{'time': '1966', 'genre': 'literature', 'category': 'general fiction'}
就不高兴地说：	{'time': '1966', 'genre': 'literature', 'category': 'general fiction'}
“官僚主义！	{'time': '1966', 'genre': 'literature', 'category': 'general fiction'}
萧长春从人们的脸色上已经看出，刚才那个事情处理得不错，这才放下心来。	{'time': '1966', 'genre': 'literature', 'category': 'general fiction'}
“我早起晚起碍着你什么了？	{'time': '1966', 'genre': 'literature', 'category': 'general fiction'}
他这儿的消息还是灵通的，干部们常来走走，社员们也常来串门，从打闹粮食事件之后，好多人都爱跟他靠近，焦振茂几乎每天晚上都得在这儿坐够了才肯走。	{'time': '1966', 'genre': 'literature', 'category': 'general fiction'}
“大懒婆、大破鞋呀！	{'time': '1966', 'genre': 'literature', 'category': 'general fiction'}
“回想起来，也是一件怪事儿。	{'time': '1966', 'genre': 'literature', 'category': 'general fiction'}
自己这么热心地给焦家提亲，这是人情往来，不会有什么不好，况且，过去也没少办这类事儿，更不会引起别人疑心；可是，这件事儿还挂着个马立本呀，这小子正血迷心窍，还没有从心坎上跟焦淑红一刀两断，要是知道自己把他心爱的人给铲走了，得罪了他，非得闹一场小矛盾！	{'time': '1966', 'genre': 'literature', 'category': 'general fiction'}
从打他家起了“积福堂”这个堂号起，五代“富贵”，一代比一代土地多，一代比一代长工多、放债多、囤积的粮食多；可是到了他这辈儿，“哗啦”一声，全败了！	{'time': '1966', 'genre': 'literature', 'category': 'general fiction'}
大人能搞这种捉鸡追狗的事儿？”	{'time': '1966', 'genre': 'literature', 'category': 'general fiction'}
孙桂英也故意说气话：	{'time': '1966', 'genre': 'literature', 'category': 'general fiction'}
“说起那天晚上的冲撞，唉，全怪表姨我。	{'time': '1966', 'genre': 'literature', 'category': 'general fiction'}
他从老人的说话和神态里，已经看出，老人家是关心闺女的，也很精明，觉着这条道儿没找错，就又耐心地用家常话劝老太太去一趟。	{'time': '1966', 'genre': 'literature', 'category': 'general fiction'}
焦二菊把刚才在河边上发生过的那场“鸡的风波”，一五一十、绘声绘色地告诉了克礼妈。	{'time': '1966', 'genre': 'literature', 'category': 'general fiction'}
“你呀，你得说清楚怎么处理，说说领导应当说的话，我们才听你的！”	{'time': '1966', 'genre': 'literature', 'category': 'general fiction'}
“小乐呀！	{'time': '1966', 'genre': 'literature', 'category': 'general fiction'}
“我得装哑巴。	{'time': '1966', 'genre': 'literature', 'category': 'general fiction'}
自己能去，拔了火罐，“病”轻了，应当自己走回来了，怎么倒找个“保驾”的护送回来呢？	{'time': '1966', 'genre': 'literature', 'category': 'general fiction'}
干什么玩？”	{'time': '1966', 'genre': 'literature', 'category': 'general fiction'}
“不是骂人，这头发又长又厚，好像毡子，我可从哪儿下刀子呀！”	{'time': '1966', 'genre': 'literature', 'category': 'general fiction'}
亲大伯快要死了，自己从小无依无靠，全是这个大伯抚养，就算是个地主吧，一般人情，人到临终还不记死仇哪。	{'time': '1966', 'genre': 'literature', 'category': 'general fiction'}
“道满，起来呀！”	{'time': '1966', 'genre': 'literature', 'category': 'general fiction'}
除了自己每时每刻都在战斗、保卫，都在增长本领之外，还要每时每刻注意克服自己应当克服的缺点；过去，她觉着自己一心一意地参加农村建设，已经满不错了，根本没有想到身上还有什么缺点，更没有想到，这些缺点在不知不觉地影响着自己在斗争里更快地提高和进步。	{'time': '1966', 'genre': 'literature', 'category': 'general fiction'}
她喊了一声：	{'time': '1966', 'genre': 'literature', 'category': 'general fiction'}
“百仲大叔说，麦熟一晌，昨天虽说都挨块看了，还要再看一遍。	{'time': '1966', 'genre': 'literature', 'category': 'general fiction'}
马立本见妈妈走出去了，两只手插在裤子兜里，在小院子里转开了圈儿。	{'time': '1966', 'genre': 'literature', 'category': 'general fiction'}
这个期间，总的方针应当完全按着上级的指示，就是一手抓斗争，一手抓生产。	{'time': '1966', 'genre': 'literature', 'category': 'general fiction'}
这位副主任越来越爱动脑筋，也越来越显得干练。	{'time': '1966', 'genre': 'literature', 'category': 'general fiction'}
他对自己这样一个“积极”的、“主动”的措施非常满意。	{'time': '1966', 'genre': 'literature', 'category': 'general fiction'}
“你到哪儿干活儿了？”	{'time': '1966', 'genre': 'literature', 'category': 'general fiction'}
他一蹬腿坐起身，挪到窗前，扒着窗户洞朝外一看，那脸上立刻就抹上了一丝微笑。	{'time': '1966', 'genre': 'literature', 'category': 'general fiction'}
“瞎说吧？”	{'time': '1966', 'genre': 'literature', 'category': 'general fiction'}
弯弯绕家里存着粮食，那是瞒不住人的，会不会往外投机，可不一定。	{'time': '1966', 'genre': 'literature', 'category': 'general fiction'}
从这一天多的情形看，没这件偶然的事儿，东山坞的邪气也能很快打下去；有了它，打下去就更快了。	{'time': '1966', 'genre': 'literature', 'category': 'general fiction'}
“那天一百张票里就有九十九张是选二菊的，马主任说一家两个当干部，不好办事儿，换个吧。	{'time': '1966', 'genre': 'literature', 'category': 'general fiction'}
积极了，人家会怀疑自己高兴，怀疑自己幸灾乐祸；消极了，人家也会怀疑，人家会怀疑自己故意稳当，实际上心中有数儿。	{'time': '1966', 'genre': 'literature', 'category': 'general fiction'}
里边有一个人，咱们得赶快把她动员出来干活儿；一边干活儿，一边帮助她进步。”	{'time': '1966', 'genre': 'literature', 'category': 'general fiction'}
屋子里仍然是黑暗的，可是那光色好看多了。	{'time': '1966', 'genre': 'literature', 'category': 'general fiction'}
哦，对啦，化消极为积极，对吧？	{'time': '1966', 'genre': 'literature', 'category': 'general fiction'}
一亩地一万斤，多给它点肉吃，我们还要追化肥哪！”	{'time': '1966', 'genre': 'literature', 'category': 'general fiction'}
有的人从心里边高兴，有的人从心里边别扭，有的人又急着找干部，想讨讨底，看看风向。	{'time': '1966', 'genre': 'literature', 'category': 'general fiction'}
她哈着腰，稍微喘了一口气，把背上的韩百安朝上颠了颠，又往上爬。	{'time': '1966', 'genre': 'literature', 'category': 'general fiction'}
萧长春感到，对这样一个老社员，光说几句宽心的话是不会使他安定下来的，也就不再说什么了。	{'time': '1966', 'genre': 'literature', 'category': 'general fiction'}
“百仲，我来给大伙儿看管牲口吧。”	{'time': '1966', 'genre': 'literature', 'category': 'general fiction'}
“韩德大他妈隔着院子，听得清清楚楚的。”	{'time': '1966', 'genre': 'literature', 'category': 'general fiction'}
“你别咬着舌头、夹着心肝说话，你说说，我们狮子院的人怎么欺负人了？	{'time': '1966', 'genre': 'literature', 'category': 'general fiction'}
那一群公鸡、母鸡，当是主人来喂粮食，呼叫着、跳跃着把弯弯绕围上了。	{'time': '1966', 'genre': 'literature', 'category': 'general fiction'}
“好，好，我给您做点顺口的吧。	{'time': '1966', 'genre': 'literature', 'category': 'general fiction'}
“连升大嫂子，我看你不如留着这劲儿，到社里干点活去。	{'time': '1966', 'genre': 'literature', 'category': 'general fiction'}
治好了？”	{'time': '1966', 'genre': 'literature', 'category': 'general fiction'}
“为什么要等秋后？”	{'time': '1966', 'genre': 'literature', 'category': 'general fiction'}
拆垛的、摊场的，只见那人流滚滚，杈子舞动，一气地紧张奔忙。	{'time': '1966', 'genre': 'literature', 'category': 'general fiction'}
这个任务太神圣了！”	{'time': '1966', 'genre': 'literature', 'category': 'general fiction'}
这两个人就是孙桂英和韩百安。	{'time': '1966', 'genre': 'literature', 'category': 'general fiction'}
[庄稼人吃完了早饭，太阳就升高了。	{'time': '1966', 'genre': 'literature', 'category': 'general fiction'}
“吃了，都睡着了。”	{'time': '1966', 'genre': 'literature', 'category': 'general fiction'}
她的背后，那伙子年轻人也跟着喊：	{'time': '1966', 'genre': 'literature', 'category': 'general fiction'}
得接受过去的教训了。	{'time': '1966', 'genre': 'literature', 'category': 'general fiction'}
火辣辣的太阳悬在空中，晒着他那发亮的、半秃的头顶。	{'time': '1966', 'genre': 'literature', 'category': 'general fiction'}
“我怎么合适了？”	{'time': '1966', 'genre': 'literature', 'category': 'general fiction'}
马大炮莫名其妙：	{'time': '1966', 'genre': 'literature', 'category': 'general fiction'}
昨个晚上，老头子第二次从金泉河边上回来，把马立本在麦子地大树下边干的勾当，一五一十跟淑红妈说了。	{'time': '1966', 'genre': 'literature', 'category': 'general fiction'}
是被革命斗争鼓动起来的精神。	{'time': '1966', 'genre': 'literature', 'category': 'general fiction'}
“玩。	{'time': '1966', 'genre': 'literature', 'category': 'general fiction'}
就算焦二菊都难得跟他碰碰头儿了。	{'time': '1966', 'genre': 'literature', 'category': 'general fiction'}
投机倒把，是不符合政策条文的事情，弯弯绕那家伙能干这种傻事？	{'time': '1966', 'genre': 'literature', 'category': 'general fiction'}
他便悄悄地退了出来，朝大庙那边摸着，心里想：	{'time': '1966', 'genre': 'literature', 'category': 'general fiction'}
她在屋地下转了个圈儿，也找不到什么事情要做，不由自主地把那条绿地儿、印着两枝梅花的手巾从柜子里掏出来，抖落开看看，又叠得平平整整压在枕头底下；又抽出来，团在两个手心里，胸口窝忍不住地跳动，左一声“唉”，右一声“唉”，像是遇见了发愁的事儿。	{'time': '1966', 'genre': 'literature', 'category': 'general fiction'}
“妈的，你这是对老人家说话哪？	{'time': '1966', 'genre': 'literature', 'category': 'general fiction'}
敲门声把他从美妙的梦境里惊醒，正要发火，一听是韩百仲来了，才一翻身爬了起来，连忙不迭地打开了门。	{'time': '1966', 'genre': 'literature', 'category': 'general fiction'}
“我说主任，多会儿下雨呀？”	{'time': '1966', 'genre': 'literature', 'category': 'general fiction'}
第一个，马之悦、萧长春跟自己汇报了情况之后，没有马上来解决，这是疏忽大意；现在发生了严重问题，觉都不睡赶来了，这就把县委和同志们加在自己头上的批评抵消了。	{'time': '1966', 'genre': 'literature', 'category': 'general fiction'}
马老四又看了儿子一眼。	{'time': '1966', 'genre': 'literature', 'category': 'general fiction'}
那天五婶亲自登门借地方，没费事儿她就答应了。	{'time': '1966', 'genre': 'literature', 'category': 'general fiction'}
说一归遭，萧长春没有单在马连福身上下捻子，因为萧长春知道，想着撂倒他的人，不是马连福，而是马之悦。	{'time': '1966', 'genre': 'literature', 'category': 'general fiction'}
萧长春从家里出来的这一路上，不断地被社员们拦住。	{'time': '1966', 'genre': 'literature', 'category': 'general fiction'}
先让每个小组都自己选一下，名单都交上来，咱们往一块儿一凑，该换的换，该补的补，省得一个组一个组跑，也免得临时凑人不妥当。”	{'time': '1966', 'genre': 'literature', 'category': 'general fiction'}
这个富裕中农这会儿什么全不顾了，什么也不怕了。	{'time': '1966', 'genre': 'literature', 'category': 'general fiction'}
有人套上牲口了，鞭子摇起来了，碌碡转起来了；天空上又出现了流云飞雨般的麦粒、糠皮；装麻包呀，装口袋呀，过磅呀；小伙子们耍了光膀，鼓起肚子，挺起胸膛，一袋一袋地扛进大庙的仓房里……	{'time': '1966', 'genre': 'literature', 'category': 'general fiction'}
她又想着昨晚上，萧长春一提到让焦克礼当队长、韩小乐当会计的事儿，自己光想到团支部和个人的脸上光彩，等到两个人不愿意接受任务的时候，自己又是那么急躁和简单……	{'time': '1966', 'genre': 'literature', 'category': 'general fiction'}
过去，他跟弯弯绕这些户很亲近，总是往一块儿凑，这会儿见了面都躲着走了，这又是怎么一回事儿呢？	{'time': '1966', 'genre': 'literature', 'category': 'general fiction'}
卖木柴、买布，再看看大牲口的行情，瞧瞧胶皮车的货色；要是碰上工地的采购员，还可以打听打听那边的情况。	{'time': '1966', 'genre': 'literature', 'category': 'general fiction'}
弯弯绕拦住他说：	{'time': '1966', 'genre': 'literature', 'category': 'general fiction'}
“真不简单呀！”	{'time': '1966', 'genre': 'literature', 'category': 'general fiction'}
焦淑红又把脸绷起来了，心想：	{'time': '1966', 'genre': 'literature', 'category': 'general fiction'}
他不是忙得顾不上吃饭，也不是不想吃饭，因为一整夜地失眠，口干舌枯，不开胃。	{'time': '1966', 'genre': 'literature', 'category': 'general fiction'}
“你们娘俩快消消气吧，事情不像你们想的那么简单呀！	{'time': '1966', 'genre': 'literature', 'category': 'general fiction'}
“噢，来信了？	{'time': '1966', 'genre': 'literature', 'category': 'general fiction'}
她的两只眼睛，就跟着老头子转开了。	{'time': '1966', 'genre': 'literature', 'category': 'general fiction'}
那狮子雕刻的非常好，从哪个角看都像活的一般。	{'time': '1966', 'genre': 'literature', 'category': 'general fiction'}
马翠清也得意地说：	{'time': '1966', 'genre': 'literature', 'category': 'general fiction'}
焦克礼从河水里抬起脑瓜子，站起身，抖落着水，走到韩道满跟前，说：	{'time': '1966', 'genre': 'literature', 'category': 'general fiction'}
刚才她乍听到这件事儿的时候，心里边乱了一阵子，怕男人一冒失，处理得不妥当，给农业社、给支部书记惹下乱子；后来又听说一切都平息下来了，还有人当她面夸奖焦克礼如何如何有办法，她也就安定下来了。	{'time': '1966', 'genre': 'literature', 'category': 'general fiction'}
支委会上研究过了，想通过这一次麦收活动。	{'time': '1966', 'genre': 'literature', 'category': 'general fiction'}
“死啦！”	{'time': '1966', 'genre': 'literature', 'category': 'general fiction'}
他们这种户，最贪图日子肥实，小伙子漂亮能挣钱。	{'time': '1966', 'genre': 'literature', 'category': 'general fiction'}
他家从办初级社当办公室起，就养成了习惯，白天黑夜都不插大门，家里有人的时候，总是大敞着门。	{'time': '1966', 'genre': 'literature', 'category': 'general fiction'}
他回过身，刚想叫马老四，一看，那边早空了，被子枕头都收拾过了。	{'time': '1966', 'genre': 'literature', 'category': 'general fiction'}
“你在雨水里泡半天了，连口气还没有喘，快去歇歇吧；明日雨一停，还得有多少大事情等着你去打发呀！”	{'time': '1966', 'genre': 'literature', 'category': 'general fiction'}
“不，当理发员。	{'time': '1966', 'genre': 'literature', 'category': 'general fiction'}
算盘有什么了不起。”	{'time': '1966', 'genre': 'literature', 'category': 'general fiction'}
马老四趁着雨小一点儿的空子，硬强着把萧长春从碾棚里拉回饲养场。	{'time': '1966', 'genre': 'literature', 'category': 'general fiction'}
“你也不会清闲吧？”	{'time': '1966', 'genre': 'literature', 'category': 'general fiction'}
说着，像一条泥鳅，从五婶的手下溜出去了。	{'time': '1966', 'genre': 'literature', 'category': 'general fiction'}
金黄金黄的棒子渣粥和碧绿碧绿的羊角葱，全都摆在桌子上了，他没有顾上吃，就先挨门挨户下通知，让赶集的人晚走一会儿，或者留下一个主事的人，参加生产队的社员碰头会，他一再跟人家声明，会议很短，一见面一宣布就散，各人干各人的事儿，一点儿耽误不了。	{'time': '1966', 'genre': 'literature', 'category': 'general fiction'}
我们来粮站还麦种，顺便接您到闺女家住几天。”	{'time': '1966', 'genre': 'literature', 'category': 'general fiction'}
“对啦，干脆改选，等她回来，告诉她改选掉了，她一定美不颠的。”	{'time': '1966', 'genre': 'literature', 'category': 'general fiction'}
“小华，来，到门口玩；玩的时候，眼睛瞧着那个门口点，谁来了，谁走了，回头告诉我。”	{'time': '1966', 'genre': 'literature', 'category': 'general fiction'}
所以他在街上碰到马之悦就没有勇气去了。	{'time': '1966', 'genre': 'literature', 'category': 'general fiction'}
“让她听听大伙儿的意见吧，选掉了，也让她心服口服才行。	{'time': '1966', 'genre': 'literature', 'category': 'general fiction'}
萧长春估计，在这个空子里边，他们一定跟买粮食的贩子串通过了，订了攻守同盟，将来要处理解决问题的时候，他们很可能翻供，不承认这件事儿。	{'time': '1966', 'genre': 'literature', 'category': 'general fiction'}
韩小乐走到寨子跟前了。	{'time': '1966', 'genre': 'literature', 'category': 'general fiction'}
我一急一火，急追着急，火赶着火，嘴巴打开，关不住门儿了，说了几句没深没浅的话。	{'time': '1966', 'genre': 'literature', 'category': 'general fiction'}
等麦子收下来，分配出去，再开展一次整社运动。	{'time': '1966', 'genre': 'literature', 'category': 'general fiction'}
“大丫头从学校里来信了？”	{'time': '1966', 'genre': 'literature', 'category': 'general fiction'}
萧长春看这情形，韩百仲的脑袋里还拧着劲儿，一时片刻不能跟自己的意见一致起来，就不急于争论下去了。	{'time': '1966', 'genre': 'literature', 'category': 'general fiction'}
又嘱咐几句，就往队部走。	{'time': '1966', 'genre': 'literature', 'category': 'general fiction'}
脑袋疼，应当打发马志德或者李秀敏把马凤兰找到自己家里去才合乎情理呀！	{'time': '1966', 'genre': 'literature', 'category': 'general fiction'}
“为什么还要团结争取呢？”	{'time': '1966', 'genre': 'literature', 'category': 'general fiction'}
一贯红润的面孔，失去了光彩，显得焦黄又黑暗，像是大病临了身，那油碎的小麻子，也格外的显眼了，总是上耸着的肩头，也簌溜溜地塌下来了：	{'time': '1966', 'genre': 'literature', 'category': 'general fiction'}
让你小子从此以后抬不起头来，直不起腰来，看你还搞社会主义不搞啦！	{'time': '1966', 'genre': 'literature', 'category': 'general fiction'}
所有的人都是快活的，被谁踩了一下子，或者撞了一下子，既不会吵闹，也不会横眉立眼儿，连理会都不理会。	{'time': '1966', 'genre': 'literature', 'category': 'general fiction'}
这会儿，灯光很亮，光影从门帘子缝儿射出来，一直洒到大门口外边的街道上。	{'time': '1966', 'genre': 'literature', 'category': 'general fiction'}
他忍不住地直起身来，朝北边望了一眼。	{'time': '1966', 'genre': 'literature', 'category': 'general fiction'}
“姥姥家，借来两本书。	{'time': '1966', 'genre': 'literature', 'category': 'general fiction'}
对啦，弯弯绕还是自己手上的人，自己真是把这伙子中农心眼儿摸透了，乖乖的吧！	{'time': '1966', 'genre': 'literature', 'category': 'general fiction'}
这小米子是从韩百安那口袋里挖出来的，野猪还愿，她来给马连福送礼儿。	{'time': '1966', 'genre': 'literature', 'category': 'general fiction'}
再一个是碾道，你看我这不是转着圈圈呀！”	{'time': '1966', 'genre': 'literature', 'category': 'general fiction'}
他想，我马立本对自己的父亲富农马斋不同样是这种困难的样子吗？	{'time': '1966', 'genre': 'literature', 'category': 'general fiction'}
哑叭挑了一头灰毛的小叫驴，挂上鞍屉，搭上驮篓，非常得意地拍了拍毛驴的屁股蛋，赶着走了。	{'time': '1966', 'genre': 'literature', 'category': 'general fiction'}
机灵鬼总是机灵鬼，一眨眼的工夫，马之悦就猜到了韩百安的来意，而且，还把这韩百安的行为，跟萧长春正“拉拢”人的事儿连到一块儿了。	{'time': '1966', 'genre': 'literature', 'category': 'general fiction'}
“骗鬼去吧，人家不让你去，你硬要走。	{'time': '1966', 'genre': 'literature', 'category': 'general fiction'}
“四爷，外边这么凉，别老在这儿站着了。”	{'time': '1966', 'genre': 'literature', 'category': 'general fiction'}
“同意。	{'time': '1966', 'genre': 'literature', 'category': 'general fiction'}
“我跳组啦。”	{'time': '1966', 'genre': 'literature', 'category': 'general fiction'}
这家是焦二菊的娘家，孩子的姥家，他的老丈人家。	{'time': '1966', 'genre': 'literature', 'category': 'general fiction'}
这个课本把他引上了斗争的道路，斗争道路上的坎坎坷坷，把一个扛过长活、拉过洋车的穷汉子摔打出来，把他从灾难和烽火里一步一步地引到胜利，引到社会主义时代的今天……	{'time': '1966', 'genre': 'literature', 'category': 'general fiction'}
那天他在焦家的后院里听了焦淑红那几句话，不仅没有心冷，反而更热了。	{'time': '1966', 'genre': 'literature', 'category': 'general fiction'}
他们都知道，麦子收割、登场、打轧、人仓，每一节儿都是一个胜利；等到公粮交上去，口粮分下来，那就算把最后的胜利拿到手里啦！	{'time': '1966', 'genre': 'literature', 'category': 'general fiction'}
每个集都从镇上、城里，或者是北京，替马小辫捎药来，送药拿钱，理所当然。	{'time': '1966', 'genre': 'literature', 'category': 'general fiction'}
他觉得，在沟北有两个人应当利用一切机会赶快拉过来，也容易拉过来；不然，一有风吹草动，他们是最可能上坏人当的。	{'time': '1966', 'genre': 'literature', 'category': 'general fiction'}
这家伙，听到一个话音儿，就请假来了，说：	{'time': '1966', 'genre': 'literature', 'category': 'general fiction'}
几年来，他没有把屁股坐下来在东山坞工作过，他也不习惯来个调查研究，完全凭着马之悦、萧长春和韩百仲几次跟他反映的问题，加上个人的经验、体会进行主观猜想和处理。	{'time': '1966', 'genre': 'literature', 'category': 'general fiction'}
男男女女，老老少少，一个跟着一个地走出来。	{'time': '1966', 'genre': 'literature', 'category': 'general fiction'}
“昨天晌午开会，我们也通知了，人到的挺齐，没通知的人全都去了，为什么开出乱子来了？”	{'time': '1966', 'genre': 'literature', 'category': 'general fiction'}
匆匆地奔这儿来了，麻利地把事儿办了，又急急地从来的那条原道儿赶回去了，最恋集的人，也不像冬闲时节那样，不慌不忙地到处逛荡。	{'time': '1966', 'genre': 'literature', 'category': 'general fiction'}
淑红，现在需要我们拿出勇敢和耐心来。	{'time': '1966', 'genre': 'literature', 'category': 'general fiction'}
焦克礼站起来，在人群里扫了一眼：	{'time': '1966', 'genre': 'literature', 'category': 'general fiction'}
她细高个子，那久经风霜的脸上刻上了条条皱纹，两只眼睛和善又很有精神。	{'time': '1966', 'genre': 'literature', 'category': 'general fiction'}
她说，那天晚上吵架，是因为马志新给马小辫来了信……”	{'time': '1966', 'genre': 'literature', 'category': 'general fiction'}
他迎着三个年轻人，看着他们的脸色，问：	{'time': '1966', 'genre': 'literature', 'category': 'general fiction'}
“别摆了，你们单干那会儿的老底子我全清楚。	{'time': '1966', 'genre': 'literature', 'category': 'general fiction'}
嘿，萧支书才不是那种人呢，几句话就把她给打回去了……”	{'time': '1966', 'genre': 'literature', 'category': 'general fiction'}
马老四比划着：	{'time': '1966', 'genre': 'literature', 'category': 'general fiction'}
[马之悦领着马小辫，紧张又艰难地朝前试探着走。	{'time': '1966', 'genre': 'literature', 'category': 'general fiction'}
不知怎么回事，除了韩百安，三个人，你看看我，我看看你，一时间都找不到话儿说了。	{'time': '1966', 'genre': 'literature', 'category': 'general fiction'}
河水只没到腿根子，河面也不宽；按说，孩子就是掉在河里，也不至于淹死；而他们都像被这突然而来的祸事迷了心窍似的，相信了不知道从哪个人嘴里提出来的“建议”，而且对这里抱着很大的希望，甚至有人肯定孩子就在河里。	{'time': '1966', 'genre': 'literature', 'category': 'general fiction'}
焦淑红挺奇怪。	{'time': '1966', 'genre': 'literature', 'category': 'general fiction'}
“吃饼子还不好办，也值得哭闹气爷爷呀？	{'time': '1966', 'genre': 'literature', 'category': 'general fiction'}
不当家不理事的年轻人，既不热心家里的小小的建设事业，也没兴趣履行世俗的礼节，除了有特殊工作的和硬被父母扣留下走不开的，全都按着自己的心思痛快地玩耍。	{'time': '1966', 'genre': 'literature', 'category': 'general fiction'}
“怎么不行？	{'time': '1966', 'genre': 'literature', 'category': 'general fiction'}
[狂风暴雨摇撼着东山坞。	{'time': '1966', 'genre': 'literature', 'category': 'general fiction'}
快让她远点儿，我怕她的臭气熏了我！”	{'time': '1966', 'genre': 'literature', 'category': 'general fiction'}
他真不明白，就这么一个小小的萧长春，竟逼的他走投无路，逼的他不能不大现原形，不能不最后跟共产党分手！	{'time': '1966', 'genre': 'literature', 'category': 'general fiction'}
“乡长还说什么？”	{'time': '1966', 'genre': 'literature', 'category': 'general fiction'}
“你们除了拿绳儿把我拴上，要不，不用想让我到地里晒着去！”	{'time': '1966', 'genre': 'literature', 'category': 'general fiction'}
他把场板上的麦鱼子、麦秸打扫干净，又用杈子沿着垛根清理着散碎的、被雨水冲泡过的麦穗，把它们归到一堆儿晒，又摊晒在场边上。	{'time': '1966', 'genre': 'literature', 'category': 'general fiction'}
“正在收麦子，下边容易出问题，我得看看去。	{'time': '1966', 'genre': 'literature', 'category': 'general fiction'}
全都说得清清楚楚。	{'time': '1966', 'genre': 'literature', 'category': 'general fiction'}
“支书心膛真宽呀！”	{'time': '1966', 'genre': 'literature', 'category': 'general fiction'}
我光顾割一担草，把个重要会耽误了。”	{'time': '1966', 'genre': 'literature', 'category': 'general fiction'}
“提起乍开始办社那事儿，我看，将来得编一本子大书。”	{'time': '1966', 'genre': 'literature', 'category': 'general fiction'}
五婶的娘家侄子走亲戚从这儿路过，焦二菊抓了个官差，把人家骑的毛驴牵过来，套上了碾子，轧的是玉米。	{'time': '1966', 'genre': 'literature', 'category': 'general fiction'}
他跟着扫场板，跟着卸车，跟着搬麦个儿，来来往往地忙着，很少说话；可是他的耳朵，他的心，一时片刻也没有得闲儿。	{'time': '1966', 'genre': 'literature', 'category': 'general fiction'}
王国忠对马连福谩骂萧长春的事不感兴趣，萧长春比过去更沉静了，连焦淑红都不像昨天那样火气大了。	{'time': '1966', 'genre': 'literature', 'category': 'general fiction'}
焦振茂接着萧老大的话茬儿说：	{'time': '1966', 'genre': 'literature', 'category': 'general fiction'}
“放开？	{'time': '1966', 'genre': 'literature', 'category': 'general fiction'}
“别啰嗦了，等人家完了事儿……”	{'time': '1966', 'genre': 'literature', 'category': 'general fiction'}
儿子的脸上今天有一种少见的喜气，又说：	{'time': '1966', 'genre': 'literature', 'category': 'general fiction'}
“您别慌，慢点儿说。”	{'time': '1966', 'genre': 'literature', 'category': 'general fiction'}
因为他们已经看出，事态的变化，离着他们追求的目标越来越远了，横在前边的关口越来越多了，心里边怎么能够消停呢……	{'time': '1966', 'genre': 'literature', 'category': 'general fiction'}
一九四八年到一九五七年，整整十年，在这十年里边，人们照着他们的誓言安排着自己的日子，改造着自己的思想，决定了自己的命运，使得东山坞起了天翻地覆的变化。	{'time': '1966', 'genre': 'literature', 'category': 'general fiction'}
“过不去了，过不去了，再也没有人的活路可走啦！”	{'time': '1966', 'genre': 'literature', 'category': 'general fiction'}
他说着，就匆匆忙忙地奔后院了。	{'time': '1966', 'genre': 'literature', 'category': 'general fiction'}
阴雨一会儿大一会儿小，狂风一会儿紧一会儿慢。	{'time': '1966', 'genre': 'literature', 'category': 'general fiction'}
“谁这么早就睡觉呀！	{'time': '1966', 'genre': 'literature', 'category': 'general fiction'}
“走，走，别在这儿瞎胡说了，多难听呀！”	{'time': '1966', 'genre': 'literature', 'category': 'general fiction'}
这当儿，马翠清风风火火地跑进来了。	{'time': '1966', 'genre': 'literature', 'category': 'general fiction'}
再让他搞，能行吗？”	{'time': '1966', 'genre': 'literature', 'category': 'general fiction'}
于是，他们从家常话谈开了，谈到村子里的斗争，谈到了国家大事。	{'time': '1966', 'genre': 'literature', 'category': 'general fiction'}
“多大呀？”	{'time': '1966', 'genre': 'literature', 'category': 'general fiction'}
“我也这样说，多不怕，就是这个任务难一点儿。”	{'time': '1966', 'genre': 'literature', 'category': 'general fiction'}
找萧长春说理吗？	{'time': '1966', 'genre': 'literature', 'category': 'general fiction'}
马之悦自己呢？	{'time': '1966', 'genre': 'literature', 'category': 'general fiction'}
“伙计，好事儿，捉奸去呀！”	{'time': '1966', 'genre': 'literature', 'category': 'general fiction'}
韩道满坐在韩小乐的身边，揪了一把马兰草，编著小辫子玩。	{'time': '1966', 'genre': 'literature', 'category': 'general fiction'}
不能给他软的，也用不着跟他绕了，就跟他刀对刀、枪对枪干一家伙，让他有法儿开台，没法儿收场……	{'time': '1966', 'genre': 'literature', 'category': 'general fiction'}
他心里边暗想：	{'time': '1966', 'genre': 'literature', 'category': 'general fiction'}
马立本回头一看，是韩小乐。	{'time': '1966', 'genre': 'literature', 'category': 'general fiction'}
今天的萧长春已经不是前天的了，前天怕你喊投吃的，怕你说农业社的坏话，想办法捂住你的嘴巴。	{'time': '1966', 'genre': 'literature', 'category': 'general fiction'}
沟北边那位老烈属王大爷用拐杖拄着地，感叹地说：	{'time': '1966', 'genre': 'literature', 'category': 'general fiction'}
他把韩百仲跟焦克礼说的话又都仔细地想了想，又把萧长春主张开这么一个会议的用心仔细地揣摩了一番。	{'time': '1966', 'genre': 'literature', 'category': 'general fiction'}
萧长春把木柴挑到集市口上，就没有勇气往里挤了，把担子一放，立刻就有人围过来。	{'time': '1966', 'genre': 'literature', 'category': 'general fiction'}
“刚才不知道怎么啦，孙桂英又哭又闹。”	{'time': '1966', 'genre': 'literature', 'category': 'general fiction'}
对弯弯绕只能是往好处争取，再往坏处准备，能把他批评得老实一点儿，更好，要是还胡搅蛮缠到底儿呢，也不要紧，目的是教育大伙儿，不光为了争取他一个人──说一遭儿，焦克礼对这个顽固的富裕中农是不抱什么希望的。	{'time': '1966', 'genre': 'literature', 'category': 'general fiction'}
脚步声、低语声，惊醒了沉睡的田野。	{'time': '1966', 'genre': 'literature', 'category': 'general fiction'}
马之悦对上级百依百顺，只要李世丹嘴唇一动，马之悦立刻就给他做到。	{'time': '1966', 'genre': 'literature', 'category': 'general fiction'}
“萧长春”、“韩百仲”、“马老四”、“焦淑红”等等，从土地改革时期的老贫农，到眼下的青年干部都包括在内，连狮子院的喜老头、福奶奶，也被他挑上了。	{'time': '1966', 'genre': 'literature', 'category': 'general fiction'}
“你吓唬她干什么呀？	{'time': '1966', 'genre': 'literature', 'category': 'general fiction'}
每天他顶着星星下地。	{'time': '1966', 'genre': 'literature', 'category': 'general fiction'}
灯捻子懒洋洋地燃烧着，一会儿“突突突”地跳几下子，黑烟子从上边那小口子一股一股地朝外冒，把罩子薰了厚厚的一层，变的像黑煤块似的。	{'time': '1966', 'genre': 'literature', 'category': 'general fiction'}
马立本写到这里，两眼潮湿了；他把写好的这几段看了一遍，胸膛激烈地跳了起来。	{'time': '1966', 'genre': 'literature', 'category': 'general fiction'}
韩百仲不耐烦地等着。	{'time': '1966', 'genre': 'literature', 'category': 'general fiction'}
马之悦一出场，她就溜了，转了好几个地方没有找到萧长春和韩百仲，最后才想到这个老贫农。	{'time': '1966', 'genre': 'literature', 'category': 'general fiction'}
他先跑到办公室找韩小乐：	{'time': '1966', 'genre': 'literature', 'category': 'general fiction'}
